transactionTimestamp,txnId,mode,amount,balance,type,narration,reference,valueDate
2019-08-01T019:38:02.000Z,M63132270,FT,150000,539769,CREDIT,salfintechproductsandsolutions August 2019,RFN79769386,2019-08-01
2019-08-01T017:27:37.000Z,M61140660,FT,3567,536202,DEBIT,ACH/maxlifeinsurance/978958600/5091047448,RFN54369752,2019-08-01
2019-08-01T019:48:36.000Z,M15100170,FT,5000,531202,DEBIT,BIL/BPAY/432994770625/motilaloswal/1771516350,RFN01307576,2019-08-01
2019-08-01T016:23:43.000Z,M42486489,FT,9000,522202,DEBIT,BIL/INF/282011610769/principalmutualfund/5014687117,RFN58783355,2019-08-01
2019-08-01T015:00:55.000Z,M92803625,FT,11345,510857,DEBIT,MMT/IMPS/974561764045/pnbpersonalloan/axis/SIB,RFN06186493,2019-08-01
2019-08-02T016:53:02.000Z,M63655895,FT,50,510807,DEBIT,UPI/506718301363/order/amul/okicici,RFN94034773,2019-08-02
2019-08-03T015:32:06.000Z,M96840288,FT,2231,508576,DEBIT,IPS/spencers/810835017872/256145420421/BANGALORE,RFN96822221,2019-08-03
2019-08-03T008:30:03.000Z,M51185347,FT,14583,493993,DEBIT,MMT/IMPS/142088569622/idbihomeloan/axis/SBIN,RFN33041124,2019-08-03
2019-08-04T013:29:12.000Z,M13469397,FT,12000,481993,DEBIT,MMT/IMPS/215925743911/rent/axis/BLR,RFN11807317,2019-08-04
2019-08-04T004:59:09.000Z,M36739380,FT,242,481751,DEBIT,VIN/burgerking/457855649189/729428881661,RFN86024827,2019-08-04
2019-08-05T002:27:07.000Z,M75996309,FT,330,481421,DEBIT,UPI/586443110699/order/uber/okhdfcbank,RFN89824259,2019-08-05
2019-08-05T017:39:50.000Z,M34495073,FT,1380,480041,DEBIT,UPI/098422640356/order/bescom/ybl,RFN04689435,2019-08-05
2019-08-07T018:35:25.000Z,M05303476,FT,1500,478541,DEBIT,VIN/indianoil/939947558663/833821338689,RFN59388177,2019-08-07
2019-08-08T000:09:21.000Z,M07733887,FT,200,478341,DEBIT,UPI/562288631583/order/kwalitybazaar/upi,RFN96097105,2019-08-08
2019-08-09T017:46:47.000Z,M78743336,FT,1299,477042,DEBIT,UPI/157657395315/order/ionbroadband/okaxis,RFN23760737,2019-08-09
2019-08-10T020:05:17.000Z,M35768082,FT,399,476643,DEBIT,UPI/618592981121/order/jio/oksbi,RFN01822713,2019-08-10
2019-08-12T017:04:04.000Z,M21276964,FT,3289,473354,DEBIT,VPS/veromoda/244841026362/700465092525/BANGALORE,RFN62136499,2019-08-12
2019-08-12T000:02:11.000Z,M10964413,FT,1110,472244,DEBIT,IPS/beijingbites/567919602787/844170544653/BANGALORE,RFN77060963,2019-08-12
2019-08-15T009:26:32.000Z,M77387267,FT,180,472064,DEBIT,UPI/671010149775/order/amul/okhdfcbank,RFN11992280,2019-08-15
2019-08-18T017:09:15.000Z,M74247698,FT,419,471645,DEBIT,UPI/803549937513/order/1mg/upi,RFN09387717,2019-08-18
2019-08-18T017:27:11.000Z,M96827610,FT,350,471295,DEBIT,VIN/tatasky/233675787126/290168960433,RFN29485340,2019-08-18
2019-08-22T019:56:18.000Z,M87023371,FT,799,470496,DEBIT,IIN/I-Debit/netflix/580064550900/792760485026,RFN03958130,2019-08-22
2019-08-24T016:21:18.000Z,M54067383,FT,299,470197,DEBIT,VPS/pvr/005335727812/292810391662/BLR,RFN66284485,2019-08-24
2019-08-25T011:22:18.000Z,M43929380,FT,150,470047,DEBIT,UPI/788562080526/order/amul/upi,RFN77230602,2019-08-25
2019-08-28T017:28:52.000Z,M62347463,FT,5201,464846,DEBIT,ACH/indiafirstlifeinsurance/869552456/9625200416,RFN63651050,2019-08-28
2019-08-28T014:28:39.000Z,M63133976,FT,99,464747,DEBIT,UPI/395709773838/order/kwalitybazaar/oksbi,RFN90697085,2019-08-28
2019-08-31T012:57:27.000Z,M67511010,FT,25005,439742,DEBIT,MMT/IMPS/554837900296/axisprivilegeccpmt/axis/SBIN,RFN07229396,2019-08-31
2019-08-31T005:54:09.000Z,M63275494,FT,15542,424200,DEBIT,MMT/IMPS/667892428773/sbieliteccpmt/axis/SIB,RFN01237317,2019-08-31
2019-09-01T005:58:50.000Z,M00513734,FT,150000,574200,CREDIT,salfintechproductsandsolutions September 2019,RFN14181341,2019-09-01
2019-09-01T011:40:59.000Z,M84994153,FT,3567,570633,DEBIT,ACH/maxlifeinsurance/938423614/2163067846,RFN39455552,2019-09-01
2019-09-01T021:39:33.000Z,M89625317,FT,11345,559288,DEBIT,MMT/IMPS/621898646336/pnbpersonalloan/axis/KIN,RFN03118183,2019-09-01
2019-09-01T003:18:31.000Z,M02157109,FT,5000,554288,DEBIT,BIL/ONL/030734384765/motilaloswal/5157797573,RFN89485245,2019-09-01
2019-09-01T018:53:42.000Z,M09669801,FT,9000,545288,DEBIT,BIL/INF/660869989301/principalmutualfund/2623555986,RFN85115506,2019-09-01
2019-09-03T018:56:06.000Z,M01958769,FT,80,545208,DEBIT,UPI/122070440047/order/skrolls/okicici,RFN40173634,2019-09-03
2019-09-03T014:25:05.000Z,M13791524,FT,100,545108,DEBIT,UPI/153449994389/order/amul/okaxis,RFN10514694,2019-09-03
2019-09-03T022:37:03.000Z,M84206974,FT,1588,543520,DEBIT,IPS/spencers/406647577386/545422652701/BANGALORE,RFN89776858,2019-09-03
2019-09-03T023:13:59.000Z,M20968754,FT,14583,528937,DEBIT,MMT/IMPS/686986102135/idbihomeloan/axis/HDF,RFN14912022,2019-09-03
2019-09-04T015:08:14.000Z,M25256322,FT,12000,516937,DEBIT,MMT/IMPS/656496155428/rent/axis/HDF,RFN64058872,2019-09-04
2019-09-05T021:57:08.000Z,M81510743,FT,898,516039,DEBIT,VIN/beijingbites/063839626305/308831654398,RFN31837533,2019-09-05
2019-09-05T004:39:42.000Z,M37054836,FT,3500,519539,CREDIT,BIL/ONL/830440498368/994302139330/2953162090,RFN03377157,2019-09-05
2019-09-05T017:55:42.000Z,M76267606,FT,1680,517859,DEBIT,UPI/866253633787/order/bescom/upi,RFN41345116,2019-09-05
2019-09-06T006:59:33.000Z,M31855096,FT,459,517400,DEBIT,VPS/pvr/961673655629/649380358307/bangalore,RFN70117932,2019-09-06
2019-09-08T001:35:49.000Z,M69506810,FT,100,517300,DEBIT,UPI/144652303101/order/kwalitybazaar/ybl,RFN43050038,2019-09-08
2019-09-08T011:22:18.000Z,M38190333,FT,80,517220,DEBIT,UPI/651317676845/order/amul/okicici,RFN47235868,2019-09-08
2019-09-09T005:23:23.000Z,M98035297,FT,1299,515921,DEBIT,UPI/423391008799/order/ionbroadband/okicici,RFN78754428,2019-09-09
2019-09-12T009:48:29.000Z,M67876121,FT,420,515501,DEBIT,VPS/eatfit/314384298325/302429015818/BANGALORE,RFN57927492,2019-09-12
2019-09-12T008:39:37.000Z,M75304819,FT,14394,501107,DEBIT,IPS/cleartrip/790544643026/362238608671/BANGALORE,RFN83443543,2019-09-12
2019-09-15T008:13:00.000Z,M46572854,FT,150,500957,DEBIT,UPI/756118418283/order/bblunt/okicici,RFN46179963,2019-09-15
2019-09-17T021:34:15.000Z,M06319035,FT,1400,499557,DEBIT,VIN/bluo/819016286442/556322265141,RFN02286553,2019-09-17
2019-09-18T021:52:08.000Z,M49946991,FT,419,499138,DEBIT,UPI/417505069895/order/chaipoint/okhdfcbank,RFN08980610,2019-09-18
2019-09-18T005:04:04.000Z,M08863745,FT,350,498788,DEBIT,VIN/tatasky/742429291513/277375225434,RFN42927295,2019-09-18
2019-09-22T008:20:55.000Z,M17086932,FT,799,497989,DEBIT,IIN/I-Debit/netflix/688130038806/810514369875,RFN36512824,2019-09-22
2019-09-24T011:29:24.000Z,M58856524,FT,399,497590,DEBIT,VPS/pvr/990167312952/905548969125/Begaluru,RFN46306770,2019-09-24
2019-09-24T005:13:29.000Z,M73863679,FT,129,497461,DEBIT,UPI/674961797010/order/uber/oksbi,RFN14271183,2019-09-24
2019-09-28T023:46:09.000Z,M05551691,FT,5201,492260,DEBIT,ACH/indiafirstlifeinsurance/473998381/4963666525,RFN26567695,2019-09-28
2019-09-28T000:08:21.000Z,M16621703,FT,702,491558,DEBIT,UPI/629499821503/order/kwalitybazaar/okicici,RFN02447638,2019-09-28
2019-09-30T010:23:17.000Z,M54743307,FT,25005,466553,DEBIT,MMT/IMPS/306261064501/axisprivilegeccpmt/axis/KIN,RFN85099521,2019-09-30
2019-09-30T005:27:34.000Z,M79633977,FT,205,466348,DEBIT,UPI/537446518671/order/amazon/upi,RFN03906672,2019-09-30
2019-09-30T023:44:36.000Z,M06956732,FT,15542,450806,DEBIT,MMT/IMPS/738607658838/sbieliteccpmt/axis/SIB,RFN32959677,2019-09-30
2019-09-30T006:16:53.000Z,M04526987,ATM,10000,440806,DEBIT,ATM/GFCEA011/CASH WDL/2019-09-30,RFN44795357,2019-09-30
2019-10-01T000:56:04.000Z,M26492653,FT,150000,590806,CREDIT,salfintechproductsandsolutions October 2019,RFN95521451,2019-10-01
2019-10-01T002:08:30.000Z,M18181002,FT,3567,587239,DEBIT,ACH/maxlifeinsurance/857650067/5136262115,RFN16566360,2019-10-01
2019-10-01T003:59:00.000Z,M70916894,FT,11345,575894,DEBIT,MMT/IMPS/118654092314/pnbpersonalloan/axis/SIB,RFN69565690,2019-10-01
2019-10-01T022:53:53.000Z,M29166520,FT,5000,570894,DEBIT,BIL/BPAY/368847478836/motilaloswal/8748847068,RFN49739336,2019-10-01
2019-10-01T003:33:25.000Z,M90755282,FT,9000,561894,DEBIT,BIL/ONL/577405250429/principalmutualfund/2344847265,RFN89212722,2019-10-01
2019-10-02T007:32:00.000Z,M36689972,FT,560,561334,DEBIT,UPI/075516892159/order/kfc/oksbi,RFN27424025,2019-10-02
2019-10-03T002:17:17.000Z,M20346811,FT,560,560774,DEBIT,IPS/pvr/543823345690/401719210041/BANGALORE,RFN24600460,2019-10-03
2019-10-03T019:32:35.000Z,M21559991,FT,14583,546191,DEBIT,MMT/IMPS/006996191679/idbihomeloan/axis/SBIN,RFN50126246,2019-10-03
2019-10-04T021:55:55.000Z,M24759141,FT,12000,534191,DEBIT,MMT/IMPS/489889646590/rent/axis/BLR,RFN15536781,2019-10-04
2019-10-04T003:36:28.000Z,M64876783,FT,3500,530691,DEBIT,VIN/veromoda/438469260145/075455968558,RFN49205629,2019-10-04
2019-10-04T010:23:05.000Z,M36591507,FT,7500,523191,DEBIT,VIN/adidas/424140139412/511505038910,RFN64207266,2019-10-04
2019-10-04T015:58:12.000Z,M43521279,FT,280,522911,DEBIT,UPI/785479500895/order/uber/oksbi,RFN84818542,2019-10-04
2019-10-05T016:47:26.000Z,M77255052,FT,1140,521771,DEBIT,UPI/175722679002/order/bescom/oksbi,RFN25557673,2019-10-05
2019-10-07T015:41:06.000Z,M81623105,FT,2000,519771,DEBIT,VIN/indianoil/712511156487/814058572983,RFN89698122,2019-10-07
2019-10-08T009:56:38.000Z,M12586706,FT,1200,518571,DEBIT,UPI/894986065643/order/kwalitybazaar/okicici,RFN46710831,2019-10-08
2019-10-10T001:12:40.000Z,M55411983,FT,1299,517272,DEBIT,UPI/600083783003/order/ionbroadband/okhdfcbank,RFN20761761,2019-10-10
2019-10-12T006:36:42.000Z,M80580692,FT,130,517142,DEBIT,UPI/205223989083/order/amul/okhdfcbank,RFN24215337,2019-10-12
2019-10-12T014:28:44.000Z,M97559535,FT,1510,515632,DEBIT,IPS/beijingbites/577588159319/051837902328/BANGALORE,RFN30872768,2019-10-12
2019-10-12T001:43:52.000Z,M08004757,FT,1240,514392,DEBIT,UPI/906304157024/order/sugar/upi,RFN98390563,2019-10-12
2019-10-13T023:39:05.000Z,M55699283,FT,6599,507793,DEBIT,VIN/nolimmits/204185193736/074516582273,RFN30364179,2019-10-13
2019-10-13T007:08:44.000Z,M18344028,FT,830,506963,DEBIT,UPI/055522031340/order/uber/ybl,RFN98240105,2019-10-13
2019-10-14T011:39:00.000Z,M60878993,FT,180,506783,DEBIT,UPI/008410724878/order/amul/okicici,RFN79729609,2019-10-14
2019-10-14T008:02:13.000Z,M08846217,FT,100,506683,DEBIT,UPI/963800165202/order/amul/ybl,RFN03503791,2019-10-14
2019-10-18T000:51:36.000Z,M12997721,FT,350,506333,DEBIT,VIN/tatasky/460566441998/805424667162,RFN32447753,2019-10-18
2019-10-22T020:14:05.000Z,M30473719,FT,799,505534,DEBIT,IIN/I-Debit/netflix/343521665246/942681297082,RFN01498685,2019-10-22
2019-10-24T003:00:09.000Z,M30386741,FT,299,505235,DEBIT,VPS/pvr/780762122776/950523748720/BANGALORE,RFN04181333,2019-10-24
2019-10-25T013:42:16.000Z,M21420180,FT,270,504965,DEBIT,UPI/387421577311/order/swiggy/oksbi,RFN02988267,2019-10-25
2019-10-26T007:40:40.000Z,M51788549,FT,2700,502265,DEBIT,VIN/indianoil/123858957650/834826013428,RFN90131293,2019-10-26
2019-10-26T019:18:59.000Z,M50781402,FT,2021,504286,CREDIT,BIL/BPAY/896255156419/233488841023/7993463050,RFN61347534,2019-10-26
2019-10-28T010:18:54.000Z,M70623062,FT,5201,499085,DEBIT,ACH/indiafirstlifeinsurance/546626237/6114074043,RFN19840566,2019-10-28
2019-10-28T006:37:52.000Z,M18704710,FT,2001,497084,DEBIT,UPI/363656178813/order/decathlon/ybl,RFN63471065,2019-10-28
2019-10-28T014:59:28.000Z,M20239982,FT,1900,495184,DEBIT,IPS/dentistclinic/181685415908/094379781194/BANGALORE,RFN40784856,2019-10-28
2019-10-31T003:24:07.000Z,M66971714,FT,25005,470179,DEBIT,MMT/IMPS/068567025374/axisprivilegeccpmt/axis/HDF,RFN55756407,2019-10-31
2019-10-31T000:58:25.000Z,M32477642,FT,15542,454637,DEBIT,MMT/IMPS/372936975222/sbieliteccpmt/axis/BLR,RFN17583751,2019-10-31
2019-11-01T018:51:41.000Z,M96712754,FT,150000,604637,CREDIT,salfintechproductsandsolutions November 2019,RFN16458907,2019-11-01
2019-11-01T022:51:05.000Z,M25387717,FT,3567,601070,DEBIT,ACH/maxlifeinsurance/559613218/0017809020,RFN88786798,2019-11-01
2019-11-01T006:56:14.000Z,M06614008,FT,11345,589725,DEBIT,MMT/IMPS/523560848743/pnbpersonalloan/axis/BLR,RFN65844308,2019-11-01
2019-11-01T013:08:20.000Z,M40394623,FT,5000,584725,DEBIT,BIL/INF/555804435355/motilaloswal/6669052138,RFN67145210,2019-11-01
2019-11-01T014:50:59.000Z,M59473571,FT,9000,575725,DEBIT,BIL/INF/062912918565/principalmutualfund/4885673539,RFN02516367,2019-11-01
2019-11-02T015:10:06.000Z,M17563193,FT,70,575655,DEBIT,UPI/117640927536/order/amul/upi,RFN57394210,2019-11-02
2019-11-03T001:36:26.000Z,M23071749,FT,2730,572925,DEBIT,IPS/spencers/162510161099/694264105775/BANGALORE,RFN33762956,2019-11-03
2019-11-03T022:57:57.000Z,M58971940,FT,14583,558342,DEBIT,MMT/IMPS/728325131397/idbihomeloan/axis/KIN,RFN00604830,2019-11-03
2019-11-04T002:51:46.000Z,M80441950,FT,12000,546342,DEBIT,MMT/IMPS/529208156179/rent/axis/SBIN,RFN83719652,2019-11-04
2019-11-04T011:41:09.000Z,M22040044,FT,890,545452,DEBIT,VIN/kfc/525315259682/291137837986,RFN61726364,2019-11-04
2019-11-04T013:12:11.000Z,M99424520,FT,799,544653,DEBIT,VIN/bblunt/259353487590/304227905113,RFN56701651,2019-11-04
2019-11-05T021:31:57.000Z,M26448057,FT,2999,541654,DEBIT,UPI/327045124247/order/indianoil/okhdfcbank,RFN61384844,2019-11-05
2019-11-05T002:52:39.000Z,M40090946,FT,1654,540000,DEBIT,UPI/347250133142/order/bescom/okhdfcbank,RFN63641459,2019-11-05
2019-11-07T012:45:57.000Z,M77708724,FT,1500,538500,DEBIT,VIN/indianoil/259368809074/980054967123,RFN04728654,2019-11-07
2019-11-08T017:53:40.000Z,M13160547,FT,240,538260,DEBIT,UPI/774161565509/order/kwalitybazaar/okaxis,RFN18178931,2019-11-08
2019-11-11T019:29:12.000Z,M49335392,FT,1299,536961,DEBIT,UPI/610127508267/order/ionbroadband/upi,RFN31653980,2019-11-11
2019-11-10T019:56:40.000Z,M32057858,FT,399,536562,DEBIT,UPI/739984734063/order/jio/okhdfcbank,RFN40408649,2019-11-10
2019-11-12T021:07:24.000Z,M44243577,FT,333,536229,DEBIT,UPI/380201673347/order/uber/upi,RFN39415039,2019-11-12
2019-11-12T011:15:26.000Z,M38359843,FT,2508,533721,DEBIT,IPS/gilly's/004755484016/804567812082/BANGALORE,RFN49899977,2019-11-12
2019-11-12T021:26:00.000Z,M62980820,FT,339,533382,DEBIT,UPI/515036487424/order/uber/oksbi,RFN42189980,2019-11-12
2019-11-15T011:11:36.000Z,M38540690,FT,130,533252,DEBIT,UPI/618292732292/order/1mg/upi,RFN25689177,2019-11-15
2019-11-15T007:51:44.000Z,M05854985,FT,3019,536271,CREDIT,BIL/BPAY/480639756105/94320092/4792530273,RFN71224808,2019-11-15
2019-11-18T020:59:13.000Z,M07658116,FT,2019,534252,DEBIT,UPI/452349118206/order/oriflame/oksbi,RFN73986628,2019-11-18
2019-11-18T003:15:37.000Z,M93320458,FT,350,533902,DEBIT,VIN/tatasky/857451306731/170904129592,RFN47327114,2019-11-18
2019-11-22T010:39:36.000Z,M56935008,FT,799,533103,DEBIT,IIN/I-Debit/netflix/607752171197/181343213782,RFN22109507,2019-11-22
2019-11-24T000:18:16.000Z,M92136912,FT,540,532563,DEBIT,VPS/pvr/792560136235/532262116386/Begaluru,RFN84373893,2019-11-24
2019-11-25T023:49:38.000Z,M02598732,FT,150,532413,DEBIT,UPI/774889925462/order/amul/ybl,RFN42260304,2019-11-25
2019-11-26T022:36:44.000Z,M81549913,FT,3500,528913,DEBIT,VIN/tonique/362703940486/808814836368,RFN27720833,2019-11-26
2019-11-26T004:08:51.000Z,M05071878,FT,2034,526879,DEBIT,VIN/spencer/521981360809/244253225706,RFN14942854,2019-11-26
2019-11-28T012:53:54.000Z,M31887652,FT,5201,521678,DEBIT,ACH/indiafirstlifeinsurance/163096618/6192596030,RFN29185436,2019-11-28
2019-11-28T006:57:59.000Z,M77739056,FT,1900,519778,DEBIT,UPI/706201823394/order/dentistclinic/okhdfcbank,RFN53144926,2019-11-28
2019-11-30T009:17:32.000Z,M22181832,FT,25005,494773,DEBIT,MMT/IMPS/597339863782/axisprivilegeccpmt/axis/SIB,RFN69985930,2019-11-30
2019-11-30T016:29:35.000Z,M68409848,FT,15542,479231,DEBIT,MMT/IMPS/025288155145/sbieliteccpmt/axis/BLR,RFN01417344,2019-11-30
2019-12-01T023:25:33.000Z,M34029349,FT,150000,629231,CREDIT,salfintechproductsandsolutions December 2019,RFN02322096,2019-12-01
2019-12-01T005:24:35.000Z,M66399529,FT,3567,625664,DEBIT,ACH/maxlifeinsurance/727153363/6831041660,RFN45135736,2019-12-01
2019-12-01T006:05:41.000Z,M28785155,FT,11345,614319,DEBIT,MMT/IMPS/012904394069/pnbpersonalloan/axis/BLR,RFN13890121,2019-12-01
2019-12-01T012:35:47.000Z,M00945454,FT,5000,609319,DEBIT,BIL/BPAY/633144479806/motilaloswal/1322212259,RFN89213007,2019-12-01
2019-12-01T007:17:16.000Z,M02920255,FT,9000,600319,DEBIT,BIL/ONL/251459050881/principalmutualfund/8498833269,RFN98996207,2019-12-01
2019-12-02T011:52:11.000Z,M89295123,FT,80,600239,DEBIT,UPI/623763396497/order/amul/ybl,RFN13388906,2019-12-02
2019-12-03T007:19:45.000Z,M91823010,FT,1409,598830,DEBIT,IPS/spencers/179940225750/000930584721/BANGALORE,RFN50850547,2019-12-03
2019-12-03T011:58:16.000Z,M95371825,FT,14583,584247,DEBIT,MMT/IMPS/805215511337/idbihomeloan/axis/BLR,RFN53157801,2019-12-03
2019-12-04T001:21:06.000Z,M44054839,FT,12000,572247,DEBIT,MMT/IMPS/366546976905/rent/axis/HDF,RFN44697201,2019-12-04
2019-12-04T012:51:10.000Z,M59031764,FT,242,572005,DEBIT,VIN/burgerking/611472440349/722320561328,RFN35256630,2019-12-04
2019-12-04T007:40:35.000Z,M12441740,FT,597,571408,DEBIT,UPI/438108197922/order/cafecofffeeday/okicici,RFN48860603,2019-12-04
2019-12-05T005:55:45.000Z,M84403674,FT,540,570868,DEBIT,UPI/275933667278/order/kwalitybazaar/okaxis,RFN39061282,2019-12-05
2019-12-05T014:46:09.000Z,M58975026,FT,1220,569648,DEBIT,UPI/771894970612/order/bescom/okicici,RFN53233010,2019-12-05
2019-12-07T022:11:16.000Z,M96289615,FT,1430,568218,DEBIT,VIN/indianoil/752912756555/193175519874,RFN46619310,2019-12-07
2019-12-08T013:29:43.000Z,M76537279,FT,200,568018,DEBIT,UPI/561510252719/order/kwalitybazaar/okicici,RFN60334592,2019-12-08
2019-12-15T012:08:19.000Z,M73667333,FT,4299,572317,CREDIT,BIL/ONL/280757928207/8884492110/2777176503,RFN68791263,2019-12-15
2019-12-09T021:13:50.000Z,M16993412,FT,1299,571018,DEBIT,UPI/635137042282/order/ionbroadband/okhdfcbank,RFN69480234,2019-12-09
2019-12-10T015:31:27.000Z,M84535786,ATM,2500,568518,DEBIT,ATM/SKBLT883/CASH WDL/2019-12-10,RFN12370450,2019-12-10
2019-12-11T006:29:15.000Z,M72404874,FT,430,568088,DEBIT,VPS/pvr/166866981592/065041562482/BLR,RFN18535284,2019-12-11
2019-12-12T020:10:44.000Z,M22407868,FT,743,567345,DEBIT,IIN/I-Debit/smokehouse/007793953909/313085325916,RFN55523145,2019-12-12
2019-12-12T009:24:48.000Z,M66004562,FT,500,566845,DEBIT,IPS/vedantsaxena/029916986763/440676467118/BANGALORE,RFN75301348,2019-12-12
2019-12-15T022:08:52.000Z,M56377965,FT,280,566565,DEBIT,UPI/824719200476/order/amul/oksbi,RFN30013063,2019-12-15
2019-12-18T020:28:04.000Z,M38214836,FT,399,566166,DEBIT,UPI/629464519884/order/hairspeak/okhdfcbank,RFN52554985,2019-12-18
2019-12-18T018:40:06.000Z,M97711747,FT,350,565816,DEBIT,VIN/tatasky/337097897941/948933708904,RFN10331136,2019-12-18
2019-12-22T009:25:29.000Z,M61388786,FT,799,565017,DEBIT,IIN/I-Debit/netflix/632382289143/473936116989,RFN49939508,2019-12-22
2019-12-24T008:34:09.000Z,M56914843,FT,299,564718,DEBIT,VPS/pvr/094940257987/691582210537/Begaluru,RFN77114785,2019-12-24
2019-12-25T007:13:18.000Z,M16260917,FT,340,564378,DEBIT,UPI/525903525104/order/zomato/ybl,RFN81727479,2019-12-25
2019-12-28T005:01:03.000Z,M57990095,FT,4999,559379,DEBIT,VPS/h&m/754228021047/720769284641/BANGALOR,RFN54583049,2019-12-28
2019-12-28T000:06:11.000Z,M53483768,FT,5201,554178,DEBIT,ACH/indiafirstlifeinsurance/416252480/6734427982,RFN64783438,2019-12-28
2019-12-28T019:12:12.000Z,M39759234,FT,1900,552278,DEBIT,UPI/539496119622/order/dentistclinic/oksbi,RFN59316625,2019-12-28
2019-12-31T008:37:03.000Z,M35930539,FT,25005,527273,DEBIT,MMT/IMPS/059794491045/axisprivilegeccpmt/axis/HDF,RFN98820987,2019-12-31
2019-12-31T012:32:17.000Z,M51340497,FT,15542,511731,DEBIT,MMT/IMPS/370553109482/sbieliteccpmt/axis/HDF,RFN08491435,2019-12-31
2020-01-01T014:20:10.000Z,M78612952,FT,150000,661731,CREDIT,salfintechproductsandsolutions January 2020,RFN39711299,2020-01-01
2020-01-01T022:54:09.000Z,M45150556,FT,3567,658164,DEBIT,ACH/maxlifeinsurance/366066068/6367240881,RFN61811539,2020-01-01
2020-01-01T012:51:05.000Z,M64460715,FT,11345,646819,DEBIT,MMT/IMPS/277577724011/pnbpersonalloan/axis/SIB,RFN71343727,2020-01-01
2020-01-01T012:28:35.000Z,M14574064,FT,5000,641819,DEBIT,BIL/BPAY/778893526219/motilaloswal/3010444422,RFN39761202,2020-01-01
2020-01-01T020:00:28.000Z,M90067616,FT,9000,632819,DEBIT,BIL/BPAY/725352016916/principalmutualfund/8642044669,RFN28376467,2020-01-01
2020-01-02T000:11:47.000Z,M15856766,FT,1209,631610,DEBIT,UPI/726774677313/order/kfc/upi,RFN80521255,2020-01-02
2020-01-03T003:00:13.000Z,M60062919,FT,1939,629671,DEBIT,IPS/spencers/948184691702/854248675305/BANGALORE,RFN47630538,2020-01-03
2020-01-03T019:35:03.000Z,M13820349,FT,14583,615088,DEBIT,MMT/IMPS/415892781174/idbihomeloan/axis/SIB,RFN62170759,2020-01-03
2020-01-04T017:01:58.000Z,M42600137,FT,607,615695,CREDIT,BIL/INF/241216139678/88844432292110/7474547904,RFN93544325,2020-01-04
2020-01-04T000:02:46.000Z,M54340314,FT,12000,603695,DEBIT,MMT/IMPS/609897679673/rent/axis/SIB,RFN19113646,2020-01-04
2020-01-04T002:22:17.000Z,M18327437,FT,3999,599696,DEBIT,VIN/h&m/522941354505/920580285633,RFN96043151,2020-01-04
2020-01-04T013:01:51.000Z,M82008439,FT,1999,597697,DEBIT,VIN/catwalk/588414612605/500933934663,RFN53065244,2020-01-04
2020-01-05T007:28:35.000Z,M34485911,FT,880,596817,DEBIT,UPI/038176372390/order/uber/okhdfcbank,RFN66170478,2020-01-05
2020-01-05T003:01:58.000Z,M03417747,FT,8902,587915,DEBIT,UPI/324677467848/order/gilly's/ybl,RFN48132722,2020-01-05
2020-01-05T000:22:09.000Z,M42956572,FT,640,587275,DEBIT,UPI/864861417813/order/uber/okhdfcbank,RFN10888566,2020-01-05
2020-01-05T022:53:06.000Z,M94029039,FT,1380,585895,DEBIT,UPI/334833019969/order/bescom/upi,RFN22777196,2020-01-05
2020-01-07T007:55:09.000Z,M17458017,FT,20208,565687,DEBIT,VIN/cleartrip/448256097249/358313454229,RFN07909421,2020-01-07
2020-01-08T009:45:42.000Z,M75988291,FT,4999,560688,DEBIT,VIN/americantourister/692481464871/364089964924,RFN96747113,2020-01-08
2020-01-09T019:31:29.000Z,M46364985,FT,1299,559389,DEBIT,UPI/620094479966/order/ionbroadband/ybl,RFN77500765,2020-01-09
2020-01-12T015:16:47.000Z,M26794365,FT,3994,555395,DEBIT,VPS/veromoda/806584390761/308232626770/bangalore,RFN57517540,2020-01-12
2020-01-12T001:23:03.000Z,M46956260,FT,1410,553985,DEBIT,UPI/789011861248/order/kfc/okaxis,RFN95603610,2020-01-12
2020-01-15T005:42:40.000Z,M88817988,FT,480,553505,DEBIT,UPI/826382157528/order/stonedmonkey/okicici,RFN53445281,2020-01-15
2020-01-18T022:19:24.000Z,M04961569,FT,750,552755,DEBIT,UPI/854068298889/order/zomato/okhdfcbank,RFN92862925,2020-01-18
2020-01-18T004:37:55.000Z,M52994115,FT,350,552405,DEBIT,VIN/tatasky/518083299927/877330892625,RFN55044345,2020-01-18
2020-01-22T014:30:40.000Z,M32404613,FT,799,551606,DEBIT,IIN/I-Debit/netflix/293222628840/694587657517,RFN82652207,2020-01-22
2020-01-23T002:52:42.000Z,M23216932,FT,189,551417,DEBIT,VPS/pvr/609375803268/735722560827/BANGALOR,RFN46914765,2020-01-23
2020-01-24T009:54:41.000Z,M14872679,FT,2001,553418,CREDIT,BIL/ONL/504792322610/00333954322234955/6373362625,RFN37943771,2020-01-24
2020-01-25T013:41:04.000Z,M38694077,FT,1440,551978,DEBIT,UPI/270856182423/order/amazon/okhdfcbank,RFN29422632,2020-01-25
2020-01-28T000:42:30.000Z,M99911850,FT,5201,546777,DEBIT,ACH/indiafirstlifeinsurance/099310201/7031252217,RFN87666164,2020-01-28
2020-01-28T001:46:56.000Z,M51004597,FT,1900,544877,DEBIT,UPI/730721493554/order/dentistclinic/okicici,RFN59763471,2020-01-28
2020-01-28T017:50:47.000Z,M39149044,FT,399,544478,DEBIT,UPI/168827482439/order/kwalitybazaar/okicici,RFN75772126,2020-01-28
2020-01-31T001:50:14.000Z,M29411862,FT,25005,519473,DEBIT,MMT/IMPS/892828042188/axisprivilegeccpmt/axis/SBIN,RFN09433948,2020-01-31
2020-01-31T019:35:53.000Z,M86266373,FT,15542,503931,DEBIT,MMT/IMPS/305414414473/sbieliteccpmt/axis/KIN,RFN78857477,2020-01-31
2020-02-01T022:11:32.000Z,M54851744,FT,150000,653931,CREDIT,salfintechproductsandsolutions February 2020,RFN10441120,2020-02-01
2020-02-01T015:12:33.000Z,M24564469,FT,3567,650364,DEBIT,ACH/maxlifeinsurance/342437192/8912938710,RFN73676599,2020-02-01
2020-02-01T001:49:25.000Z,M57064114,FT,11345,639019,DEBIT,MMT/IMPS/011932845509/pnbpersonalloan/axis/HDF,RFN99329270,2020-02-01
2020-02-01T015:51:56.000Z,M93072650,FT,5000,634019,DEBIT,BIL/BPAY/287230950675/motilaloswal/0008280387,RFN08871451,2020-02-01
2020-02-01T000:54:21.000Z,M68996068,FT,9000,625019,DEBIT,BIL/BPAY/901166358878/principalmutualfund/5629842952,RFN78964972,2020-02-01
2020-02-02T001:12:13.000Z,M22912307,FT,670,624349,DEBIT,UPI/264840765905/order/cafecofeeday/okicici,RFN86274225,2020-02-02
2020-02-03T006:22:33.000Z,M46821052,FT,3100,621249,DEBIT,IPS/spencers/535789896262/986033718665/BANGALORE,RFN81026541,2020-02-03
2020-02-03T014:45:42.000Z,M19409796,FT,14583,606666,DEBIT,MMT/IMPS/482016692112/idbihomeloan/axis/KIN,RFN45076355,2020-02-03
2020-02-04T019:25:17.000Z,M08404068,FT,12000,594666,DEBIT,MMT/IMPS/142266242241/rent/axis/BLR,RFN40405448,2020-02-04
2020-02-04T012:10:33.000Z,M34163988,FT,550,594116,DEBIT,VIN/kfc/646511295969/420704178481,RFN63740642,2020-02-04
2020-02-05T006:31:59.000Z,M34862981,FT,1380,592736,DEBIT,UPI/631391203735/order/bescom/okhdfcbank,RFN88068426,2020-02-05
2020-02-07T017:42:36.000Z,M93767624,FT,2500,590236,DEBIT,VIN/indianoil/541243601906/381901785544,RFN57821543,2020-02-07
2020-02-08T015:32:27.000Z,M07017854,FT,1200,589036,DEBIT,UPI/849455494774/order/kwalitybazaar/upi,RFN53353347,2020-02-08
2020-02-09T019:09:21.000Z,M61700450,FT,1299,587737,DEBIT,UPI/865290035953/order/ionbroadband/oksbi,RFN36365507,2020-02-09
2020-02-10T005:19:34.000Z,M33764710,FT,399,587338,DEBIT,UPI/066013309552/order/jio/ybl,RFN85366072,2020-02-10
2020-02-12T006:32:56.000Z,M49509505,FT,1800,585538,DEBIT,UPI/286180501505/order/gilly's/upi,RFN76197003,2020-02-12
2020-02-15T017:18:49.000Z,M39297929,FT,180,585358,DEBIT,UPI/074178628066/order/amul/oksbi,RFN69228727,2020-02-15
2020-02-18T005:09:43.000Z,M26389693,FT,160,585198,DEBIT,UPI/432992848966/order/1mg/ybl,RFN97091914,2020-02-18
2020-02-18T008:41:32.000Z,M38552303,FT,350,584848,DEBIT,VIN/tatasky/935278576630/042723959194,RFN44023309,2020-02-18
2020-02-22T004:55:20.000Z,M57486019,FT,799,584049,DEBIT,IIN/I-Debit/netflix/079564662092/393924811095,RFN99569134,2020-02-22
2020-02-25T007:19:17.000Z,M96501777,FT,50,583999,DEBIT,UPI/389685055930/order/amul/okhdfcbank,RFN92385079,2020-02-25
2020-02-28T021:20:21.000Z,M71588655,FT,310,583689,DEBIT,UPI/343905535608/order/uber/ybl,RFN27617358,2020-02-28
2020-02-28T005:30:49.000Z,M48482120,FT,5201,578488,DEBIT,ACH/indiafirstlifeinsurance/381011045/7770228681,RFN35416899,2020-02-28
2020-02-28T002:59:39.000Z,M39474802,FT,1900,576588,DEBIT,UPI/498410870424/order/dentistclinic/okaxis,RFN34652540,2020-02-28
2020-02-28T000:42:29.000Z,M56834654,FT,330,576258,DEBIT,UPI/687716851336/order/uber/ybl,RFN48699675,2020-02-28
2020-02-28T018:50:16.000Z,M62682265,FT,99,576159,DEBIT,UPI/202900476096/order/kwalitybazaar/okicici,RFN03543063,2020-02-28
2020-02-28T011:20:05.000Z,M01546945,FT,25005,551154,DEBIT,MMT/IMPS/935698323537/axisprivilegeccpmt/axis/SIB,RFN44153377,2020-02-28
2020-02-28T011:50:10.000Z,M21518803,FT,15542,535612,DEBIT,MMT/IMPS/919128066889/sbieliteccpmt/axis/SIB,RFN04022168,2020-02-28
2020-03-01T023:54:43.000Z,M62445095,FT,150000,685612,CREDIT,salfintechproductsandsolutions March 2020,RFN03189349,2020-03-01
2020-03-01T010:23:47.000Z,M65228520,FT,3567,682045,DEBIT,ACH/maxlifeinsurance/081972357/0630129758,RFN28096115,2020-03-01
2020-03-01T007:01:10.000Z,M01549859,FT,11345,670700,DEBIT,MMT/IMPS/990570695553/pnbpersonalloan/axis/SIB,RFN24572591,2020-03-01
2020-03-01T011:13:38.000Z,M89109128,FT,5000,665700,DEBIT,BIL/ONL/338524224032/motilaloswal/8519961033,RFN78486252,2020-03-01
2020-03-01T006:18:54.000Z,M80343331,FT,9000,656700,DEBIT,BIL/ONL/098212155238/principalmutualfund/2186334937,RFN34008302,2020-03-01
2020-03-02T003:17:04.000Z,M49356395,FT,240,656460,DEBIT,UPI/149153538849/order/amul/ybl,RFN11145404,2020-03-02
2020-03-03T012:14:18.000Z,M82673887,FT,1536,654924,DEBIT,IPS/bigbasket/629545305741/033719255513/BANGALORE,RFN49940649,2020-03-03
2020-03-03T007:40:06.000Z,M71993550,FT,14583,640341,DEBIT,MMT/IMPS/906288373212/idbihomeloan/axis/KIN,RFN85090560,2020-03-03
2020-03-04T018:39:10.000Z,M02339472,FT,12000,628341,DEBIT,MMT/IMPS/226484789428/rent/axis/KIN,RFN80242164,2020-03-04
2020-03-04T014:41:24.000Z,M14169886,FT,242,628099,DEBIT,UPI/367483349840/order/leongrill/okicici,RFN10602767,2020-03-04
2020-03-05T014:25:25.000Z,M32997606,FT,1561,626538,DEBIT,UPI/745053723018/order/bescom/upi,RFN96077492,2020-03-05
2020-03-07T020:02:04.000Z,M64913733,FT,1500,625038,DEBIT,VIN/indianoil/580528478408/698447428014,RFN37180106,2020-03-07
2020-03-08T008:03:25.000Z,M23918815,FT,220,624818,DEBIT,UPI/375415482543/order/sriganeshmedical/upi,RFN82878648,2020-03-08
2020-03-09T013:21:41.000Z,M02363661,FT,1299,623519,DEBIT,UPI/427323364662/order/ionbroadband/okaxis,RFN23031706,2020-03-09
2020-03-11T023:54:14.000Z,M73500454,FT,3006,626525,CREDIT,BIL/ONL/717135859347/23435678032/1523192967,RFN46602295,2020-03-11
2020-03-12T023:59:32.000Z,M97138619,FT,13999,612526,DEBIT,VPS/amazon/704917980490/594728522370/BENGALURU,RFN85043280,2020-03-12
2020-03-12T004:45:02.000Z,M16584796,FT,310,612216,DEBIT,IIN/I-Debit/a2b/686198708093/975630452009,RFN69190198,2020-03-12
2020-03-15T003:08:42.000Z,M94738309,FT,180,612036,DEBIT,UPI/142918824769/order/amul/okicici,RFN53153932,2020-03-15
2020-03-18T003:02:13.000Z,M68548005,FT,1400,610636,DEBIT,UPI/009153506122/order/myntra/oksbi,RFN56786648,2020-03-18
2020-03-18T013:32:16.000Z,M22257118,FT,350,610286,DEBIT,VIN/tatasky/832759351459/658990461222,RFN70381937,2020-03-18
2020-03-21T006:44:58.000Z,M96420794,FT,850,609436,DEBIT,VIN/bblunt/553125249894/081289166421,RFN79858518,2020-03-21
2020-03-22T018:03:23.000Z,M22002991,FT,799,608637,DEBIT,IIN/I-Debit/netflix/431904858118/368446370980,RFN68408986,2020-03-22
2020-03-28T021:55:29.000Z,M09661711,FT,5201,603436,DEBIT,ACH/indiafirstlifeinsurance/877138436/0347257310,RFN89045931,2020-03-28
2020-03-28T016:55:15.000Z,M59063377,FT,29,603407,DEBIT,UPI/517536519041/order/kwalitybazaar/okicici,RFN81873221,2020-03-28
2020-03-31T003:03:16.000Z,M68814702,FT,25005,578402,DEBIT,MMT/IMPS/644361704773/axisprivilegeccpmt/axis/KIN,RFN96731250,2020-03-31
2020-03-31T021:49:23.000Z,M28184200,FT,15542,562860,DEBIT,MMT/IMPS/706511137164/sbieliteccpmt/axis/BLR,RFN66803931,2020-03-31
2020-04-01T010:01:37.000Z,M76523797,FT,150000,712860,CREDIT,salfintechproductsandsolutions April 2020,RFN77916723,2020-04-01
2020-04-01T012:35:01.000Z,M78636360,FT,3567,709293,DEBIT,ACH/maxlifeinsurance/855634396/4698084028,RFN13970372,2020-04-01
2020-04-01T002:10:04.000Z,M64739575,FT,11345,697948,DEBIT,MMT/IMPS/787126702494/pnbpersonalloan/axis/SIB,RFN70362957,2020-04-01
2020-04-01T008:04:11.000Z,M95018087,FT,5000,692948,DEBIT,BIL/BPAY/125718162287/motilaloswal/8916657749,RFN02041060,2020-04-01
2020-04-01T018:35:24.000Z,M88828633,FT,9000,683948,DEBIT,BIL/INF/311473357835/principalmutualfund/8994149714,RFN84776277,2020-04-01
2020-04-02T005:37:13.000Z,M78831814,FT,670,683278,DEBIT,UPI/842689344637/order/mrgoofy's/okaxis,RFN52759112,2020-04-02
2020-04-03T014:10:24.000Z,M74212511,FT,1983,681295,DEBIT,IPS/spencers/607902682819/113836525405/BANGALORE,RFN82862367,2020-04-03
2020-04-03T018:14:07.000Z,M89446419,FT,14583,666712,DEBIT,MMT/IMPS/312062448680/idbihomeloan/axis/SIB,RFN32543906,2020-04-03
2020-04-04T013:29:57.000Z,M64602758,FT,12000,654712,DEBIT,MMT/IMPS/844399159495/rent/axis/BLR,RFN65603199,2020-04-04
2020-04-04T011:53:37.000Z,M81635916,FT,667,654045,DEBIT,UPI/273800149322/order/zomato/okicici,RFN84281805,2020-04-04
2020-04-05T021:29:32.000Z,M14125525,FT,560,653485,DEBIT,UPI/537610013016/order/uber/oksbi,RFN18556481,2020-04-05
2020-04-05T021:36:34.000Z,M90163628,FT,880,652605,DEBIT,UPI/278987150798/order/bescom/upi,RFN00173816,2020-04-05
2020-04-05T020:00:56.000Z,M57784635,FT,2016,654621,CREDIT,BIL/INF/455943300739/435456745323234353/7267018405,RFN31200902,2020-04-05
2020-04-07T000:17:40.000Z,M66798061,FT,2000,652621,DEBIT,VIN/indianoil/550922722256/745901438015,RFN57758449,2020-04-07
2020-04-08T018:03:06.000Z,M12987965,FT,1299,651322,DEBIT,UPI/495112778814/order/skybags/okhdfcbank,RFN71081439,2020-04-08
2020-04-09T013:58:40.000Z,M37120013,FT,1299,650023,DEBIT,UPI/037792788449/order/ionbroadband/ybl,RFN28724871,2020-04-09
2020-04-12T015:00:43.000Z,M52194570,FT,7999,642024,DEBIT,VIN/titaneyeplus/459356802532/137067272175,RFN97645628,2020-04-12
2020-04-12T012:43:31.000Z,M18146182,FT,3500,638524,DEBIT,IPS/rahulkumar/799527950642/547691394512/BANGALORE,RFN40232859,2020-04-12
2020-04-15T010:30:28.000Z,M39683912,FT,380,638144,DEBIT,UPI/372725276828/order/amul/okaxis,RFN15851054,2020-04-15
2020-04-18T009:10:25.000Z,M00578503,FT,2100,636044,DEBIT,VIN/only/968525925865/486275607122,RFN32299972,2020-04-18
2020-04-18T005:49:38.000Z,M15099135,FT,350,635694,DEBIT,VIN/tatasky/091628450902/461265612375,RFN85246874,2020-04-18
2020-04-22T019:27:05.000Z,M96755288,FT,799,634895,DEBIT,IIN/I-Debit/netflix/578880235612/430811962161,RFN10507874,2020-04-22
2020-04-24T016:59:38.000Z,M65000111,FT,499,634396,DEBIT,VPS/pvr/787363701254/837109923231/Begaluru,RFN52204114,2020-04-24
2020-04-25T012:17:30.000Z,M76086036,FT,1510,632886,DEBIT,UPI/505287769541/order/landmark/okicici,RFN79722717,2020-04-25
2020-04-28T016:01:55.000Z,M05070255,FT,5201,627685,DEBIT,ACH/indiafirstlifeinsurance/661651316/4531281740,RFN05137775,2020-04-28
2020-04-28T019:21:17.000Z,M35537725,FT,789,626896,DEBIT,VPS/irctc/861937979844/268825751771/BLR,RFN26432575,2020-04-28
2020-04-30T002:34:18.000Z,M74459961,FT,25005,601891,DEBIT,MMT/IMPS/834073053905/axisprivilegeccpmt/axis/KIN,RFN04563177,2020-04-30
2020-04-30T013:49:27.000Z,M30278460,FT,15542,586349,DEBIT,MMT/IMPS/945336883580/sbieliteccpmt/axis/KIN,RFN36170279,2020-04-30
2020-05-01T011:25:29.000Z,M84377800,FT,150000,736349,CREDIT,salfintechproductsandsolutions May 2020,RFN62092836,2020-05-01
2020-05-01T015:02:17.000Z,M41330129,FT,3567,732782,DEBIT,ACH/maxlifeinsurance/839506607/6306713891,RFN49339400,2020-05-01
2020-05-01T021:12:41.000Z,M94566069,FT,11345,721437,DEBIT,MMT/IMPS/991767704024/pnbpersonalloan/axis/SIB,RFN20961844,2020-05-01
2020-05-01T002:55:05.000Z,M03335190,FT,5000,716437,DEBIT,BIL/BPAY/856047715361/motilaloswal/8251419687,RFN39524303,2020-05-01
2020-05-01T008:08:04.000Z,M38859599,FT,9000,707437,DEBIT,BIL/INF/652956645533/principalmutualfund/3623914324,RFN56638359,2020-05-01
2020-05-02T002:03:04.000Z,M89818334,FT,160,707277,DEBIT,UPI/489585495603/order/amul/okhdfcbank,RFN78861706,2020-05-02
2020-05-03T006:15:09.000Z,M26945869,FT,3290,703987,DEBIT,IPS/spencers/541271441305/171527789561/BANGALORE,RFN48094747,2020-05-03
2020-05-03T001:21:07.000Z,M84592942,FT,14583,689404,DEBIT,MMT/IMPS/274880895125/idbihomeloan/axis/HDF,RFN60216033,2020-05-03
2020-05-04T008:08:13.000Z,M63415035,FT,12000,677404,DEBIT,MMT/IMPS/683335014267/rent/axis/SIB,RFN97703442,2020-05-04
2020-05-04T001:57:21.000Z,M11590822,FT,496,676908,DEBIT,VIN/eatfit/515806741121/435395239126,RFN95881166,2020-05-04
2020-05-04T003:59:51.000Z,M98866285,FT,6989,669919,DEBIT,VPS/h&m/441492751510/616435383770/Begaluru,RFN51233257,2020-05-04
2020-05-04T004:02:02.000Z,M47354931,FT,4503,665416,DEBIT,VPS/bangalorecentral/332870238618/638417011112/BANGALOR,RFN95778592,2020-05-04
2020-05-05T020:14:16.000Z,M54889891,FT,402,665014,DEBIT,UPI/306014147137/order/uber/okhdfcbank,RFN07212790,2020-05-05
2020-05-05T019:11:01.000Z,M35939192,FT,8472,656542,DEBIT,VIN/nolimmits/009178662400/125544846687,RFN10927679,2020-05-05
2020-05-05T011:37:24.000Z,M77778615,FT,442,656100,DEBIT,UPI/882731091683/order/uber/upi,RFN00638415,2020-05-05
2020-05-05T008:22:32.000Z,M44581207,FT,1280,654820,DEBIT,UPI/451023595253/order/bescom/ybl,RFN22902108,2020-05-05
2020-05-07T009:59:52.000Z,M73837012,FT,1500,653320,DEBIT,VIN/indianoil/395637551383/046123039392,RFN42565642,2020-05-07
2020-05-08T023:30:49.000Z,M14932779,FT,799,652521,DEBIT,UPI/362799341267/order/bblunt/upi,RFN11839738,2020-05-08
2020-05-09T001:29:15.000Z,M07628283,FT,1299,651222,DEBIT,UPI/849298001075/order/ionbroadband/okhdfcbank,RFN05024138,2020-05-09
2020-05-10T000:42:09.000Z,M75510377,FT,399,650823,DEBIT,UPI/979584093846/order/jio/oksbi,RFN09854853,2020-05-10
2020-05-11T003:26:55.000Z,M03869677,FT,1540,652363,CREDIT,BIL/INF/037010921189/48282029013/9272086723,RFN45180434,2020-05-11
2020-05-12T003:50:49.000Z,M93189107,FT,3289,649074,DEBIT,VPS/gilly's/347844563102/331411162466/bangalore,RFN50171358,2020-05-12
2020-05-15T002:38:58.000Z,M37545783,FT,70,649004,DEBIT,UPI/975079865295/order/amul/okicici,RFN57329431,2020-05-15
2020-05-18T011:44:24.000Z,M32826090,ATM,3500,645504,DEBIT,ATM/DADCM718/CASH WDL/2020-05-18,RFN59290871,2020-05-18
2020-05-18T014:49:37.000Z,M99409416,FT,350,645154,DEBIT,VIN/tatasky/815044312557/206759332432,RFN18244869,2020-05-18
2020-05-22T019:58:51.000Z,M81439860,FT,799,644355,DEBIT,IIN/I-Debit/netflix/380915423866/705816469724,RFN64016148,2020-05-22
2020-05-24T012:45:25.000Z,M95682898,FT,299,644056,DEBIT,VPS/pvr/333832199526/607394556641/BANGALORE,RFN70742058,2020-05-24
2020-05-25T012:22:25.000Z,M94836692,ATM,1000,643056,DEBIT,ATM/BESLX088/CASH WDL/2020-05-25,RFN42648280,2020-05-25
2020-05-28T015:45:35.000Z,M72733467,FT,99,642957,DEBIT,UPI/121694120526/order/kwalitybazaar/ybl,RFN37435072,2020-05-28
2020-05-28T002:15:20.000Z,M25314492,FT,5201,637756,DEBIT,ACH/indiafirstlifeinsurance/894319642/2334193663,RFN47042883,2020-05-28
2020-05-31T005:12:24.000Z,M01826206,FT,25005,612751,DEBIT,MMT/IMPS/656842035840/axisprivilegeccpmt/axis/KIN,RFN31966200,2020-05-31
2020-05-31T009:37:10.000Z,M27367232,FT,15542,597209,DEBIT,MMT/IMPS/323995308686/sbieliteccpmt/axis/SIB,RFN32031827,2020-05-31
2020-06-01T023:30:31.000Z,M84486032,FT,150000,747209,CREDIT,salfintechproductsandsolutions June 2020,RFN47002989,2020-06-01
2020-06-01T023:09:54.000Z,M96653097,FT,3567,743642,DEBIT,ACH/maxlifeinsurance/227640695/8830726793,RFN58473983,2020-06-01
2020-06-01T019:01:05.000Z,M77913473,FT,11345,732297,DEBIT,MMT/IMPS/147289735040/pnbpersonalloan/axis/KIN,RFN60752395,2020-06-01
2020-06-01T019:12:35.000Z,M30776456,FT,5000,727297,DEBIT,BIL/ONL/127790120156/motilaloswal/2350441779,RFN67986625,2020-06-01
2020-06-01T019:08:24.000Z,M10857284,FT,9000,718297,DEBIT,BIL/ONL/188456122492/principalmutualfund/1948440109,RFN19762096,2020-06-01
2020-06-02T002:35:16.000Z,M04309831,FT,89000,629297,DEBIT,VIN/iplanet/209761091732/816663099350,RFN71861840,2020-06-02
2020-06-03T014:45:38.000Z,M37557867,FT,1200,628097,DEBIT,IPS/bigbasket/083980556780/127298096618/BANGALORE,RFN17476975,2020-06-03
2020-06-03T001:31:44.000Z,M16487570,FT,14583,613514,DEBIT,MMT/IMPS/747079729510/idbihomeloan/axis/BLR,RFN71067994,2020-06-03
2020-06-04T006:33:50.000Z,M57461542,FT,12000,601514,DEBIT,MMT/IMPS/848219757404/rent/axis/KIN,RFN56372505,2020-06-04
2020-06-04T001:37:24.000Z,M24789015,FT,249,601265,DEBIT,VIN/kfc/271183764735/163904007207,RFN81870799,2020-06-04
2020-06-05T015:54:04.000Z,M83360902,FT,120,601145,DEBIT,UPI/474946866850/order/uber/upi,RFN44919363,2020-06-05
2020-06-05T014:22:56.000Z,M57351486,FT,1480,599665,DEBIT,UPI/081210849877/order/bescom/upi,RFN66827300,2020-06-05
2020-06-07T019:36:40.000Z,M84625187,FT,2110,597555,DEBIT,UPI/988896357872/order/plated/okhdfcbank,RFN84011591,2020-06-07
2020-06-08T004:26:22.000Z,M94982383,ATM,2000,595555,DEBIT,ATM/BDTJA386/CASH WDL/2020-06-08,RFN30555175,2020-06-08
2020-06-08T023:46:29.000Z,M59874852,FT,3080,592475,DEBIT,VIN/landmark/491549063751/652489225375,RFN07284241,2020-06-08
2020-06-09T009:45:12.000Z,M01572251,FT,1299,591176,DEBIT,UPI/648046544012/order/ionbroadband/upi,RFN09717687,2020-06-09
2020-06-12T011:30:45.000Z,M76982226,FT,9999,581177,DEBIT,VPS/adidas/922887757041/167132335378/BLR,RFN93465179,2020-06-12
2020-06-12T016:34:38.000Z,M47825698,FT,230,580947,DEBIT,UPI/968789726201/order/eatfit/okhdfcbank,RFN32505471,2020-06-12
2020-06-15T015:31:48.000Z,M12748359,FT,210,580737,DEBIT,UPI/930182690024/order/amul/oksbi,RFN66368885,2020-06-15
2020-06-18T023:24:32.000Z,M98955358,FT,599,580138,DEBIT,UPI/307422545454/order/croma/okhdfcbank,RFN88579175,2020-06-18
2020-06-18T014:35:33.000Z,M58084192,FT,350,579788,DEBIT,VIN/tatasky/333846022720/455932618540,RFN17107931,2020-06-18
2020-06-19T006:02:17.000Z,M87645700,FT,4802,584590,CREDIT,BIL/ONL/893340243952/0292192233/4676356299,RFN17092498,2020-06-19
2020-06-19T023:20:14.000Z,M06682612,FT,300,584890,CREDIT,BIL/ONL/847113498692/0324830223/6699776436,RFN25239656,2020-06-19
2020-06-22T023:25:18.000Z,M51263216,FT,799,584091,DEBIT,IIN/I-Debit/netflix/152127471225/968337540144,RFN05848509,2020-06-22
2020-06-28T011:58:13.000Z,M43297685,FT,5201,578890,DEBIT,ACH/indiafirstlifeinsurance/789424060/0154979737,RFN78078796,2020-06-28
2020-06-28T000:33:29.000Z,M06805308,FT,59,578831,DEBIT,UPI/618931567988/order/kwalitybazaar/okicici,RFN55935825,2020-06-28
2020-06-30T012:08:01.000Z,M81368745,FT,25005,553826,DEBIT,MMT/IMPS/263226968514/axisprivilegeccpmt/axis/KIN,RFN80609648,2020-06-30
2020-06-30T008:28:34.000Z,M54034128,FT,15542,538284,DEBIT,MMT/IMPS/296857345890/sbieliteccpmt/axis/SBIN,RFN01573107,2020-06-30
2020-07-01T009:40:35.000Z,M89863413,FT,150000,688284,CREDIT,salfintechproductsandsolutions July 2020,RFN64695892,2020-07-01
2020-07-01T007:37:06.000Z,M09870531,FT,3567,684717,DEBIT,ACH/maxlifeinsurance/620093962/7356807976,RFN03020771,2020-07-01
2020-07-01T023:53:47.000Z,M62891257,FT,11345,673372,DEBIT,MMT/IMPS/253702894191/pnbpersonalloan/axis/KIN,RFN06001902,2020-07-01
2020-07-01T023:17:57.000Z,M43579408,FT,5000,668372,DEBIT,BIL/INF/064465507527/motilaloswal/2108813728,RFN07230636,2020-07-01
2020-07-01T009:47:04.000Z,M69608046,FT,9000,659372,DEBIT,BIL/INF/672326343119/principalmutualfund/2353150835,RFN50171671,2020-07-01
2020-07-02T023:32:58.000Z,M84606717,FT,230,659142,DEBIT,UPI/360885143765/order/amul/upi,RFN78027613,2020-07-02
2020-07-03T002:59:19.000Z,M25849614,FT,1599,657543,DEBIT,IPS/spencers/460538703368/190022953572/BANGALORE,RFN96940455,2020-07-03
2020-07-03T007:01:25.000Z,M49644995,FT,14583,642960,DEBIT,MMT/IMPS/642270628490/idbihomeloan/axis/SIB,RFN89783023,2020-07-03
2020-07-04T016:45:49.000Z,M94955894,FT,12000,630960,DEBIT,MMT/IMPS/014768246905/rent/axis/SIB,RFN53357895,2020-07-04
2020-07-04T022:16:40.000Z,M36395642,FT,242,630718,DEBIT,VIN/burgerking/637602816077/390751464005,RFN79472551,2020-07-04
2020-07-05T021:22:39.000Z,M92625623,FT,540,630178,DEBIT,UPI/623409376263/order/kfc/okhdfcbank,RFN14589901,2020-07-05
2020-07-05T019:41:41.000Z,M78989250,FT,1542,628636,DEBIT,UPI/270395433623/order/bescom/okaxis,RFN18572905,2020-07-05
2020-07-07T004:04:28.000Z,M79928126,FT,2400,626236,DEBIT,VIN/indianoil/721404582784/308525290334,RFN75426751,2020-07-07
2020-07-08T000:25:44.000Z,M97587151,FT,3598,622638,DEBIT,UPI/686402388554/order/landmark/okaxis,RFN70075714,2020-07-08
2020-07-09T013:17:07.000Z,M75438874,FT,1299,621339,DEBIT,UPI/520935518518/order/ionbroadband/okaxis,RFN05348985,2020-07-09
2020-07-12T001:15:10.000Z,M18875711,FT,2889,618450,DEBIT,VPS/veromoda/114322341138/659128137632/BANGALORE,RFN12980296,2020-07-12
2020-07-12T021:15:50.000Z,M78276555,FT,410,618040,DEBIT,UPI/071820550458/order/eatfit/ybl,RFN95719487,2020-07-12
2020-07-15T018:28:11.000Z,M47247436,FT,790,617250,DEBIT,UPI/393034958201/order/beijingbites/oksbi,RFN31108902,2020-07-15
2020-07-16T020:29:14.000Z,M05579051,FT,3123,620373,CREDIT,BIL/BPAY/760311609927/323455920392/5234877813,RFN07018757,2020-07-16
2020-07-18T000:54:16.000Z,M96169627,FT,3999,616374,DEBIT,UPI/259646047229/order/bangalorecentral/okicici,RFN71980051,2020-07-18
2020-07-18T017:17:19.000Z,M70119449,FT,350,616024,DEBIT,VIN/tatasky/096909154656/930162325235,RFN69176669,2020-07-18
2020-07-22T014:51:21.000Z,M50068058,FT,799,615225,DEBIT,IIN/I-Debit/netflix/067684770582/719409858320,RFN13478592,2020-07-22
2020-07-24T018:57:24.000Z,M20529681,FT,450,614775,DEBIT,VPS/pvr/407410085459/449535941771/Begaluru,RFN31338404,2020-07-24
2020-07-25T008:45:29.000Z,M35990192,FT,50,614725,DEBIT,UPI/187449867038/order/amul/upi,RFN17109672,2020-07-25
2020-07-28T011:20:59.000Z,M32025774,FT,5201,609524,DEBIT,ACH/indiafirstlifeinsurance/069385641/3057418439,RFN39467304,2020-07-28
2020-07-28T007:39:46.000Z,M43754888,FT,120,609404,DEBIT,UPI/737036744047/order/kwalitybazaar/upi,RFN52248003,2020-07-28
2020-07-31T023:22:32.000Z,M31490112,FT,25005,584399,DEBIT,MMT/IMPS/120765120561/axisprivilegeccpmt/axis/SBIN,RFN86293903,2020-07-31
2020-07-31T009:55:24.000Z,M79727970,FT,15542,568857,DEBIT,MMT/IMPS/007746756296/sbieliteccpmt/axis/KIN,RFN51205213,2020-07-31
2020-07-31T021:34:43.000Z,M51220268,ATM,5000,563857,DEBIT,ATM/OZXHH510/CASH WDL/2020-07-31,RFN42406546,2020-07-31
