transactionTimestamp,txnId,mode,amount,balance,type,narration,reference,valueDate
2019-08-01T002:04:58.000Z,M57120180,FT,120000,539769,CREDIT,salfintechproductsandsolutions August 2019,RFN73916208,2019-08-01
2019-08-01T007:39:03.000Z,M47427964,FT,3567,536202,DEBIT,ACH/maxlifeinsurance/897211057/6619269612,RFN97406535,2019-08-01
2019-08-01T012:11:41.000Z,M61154713,FT,12000,524202,DEBIT,BIL/INF/001424551786/motilaloswal/9149045647,RFN53648712,2019-08-01
2019-08-01T001:14:52.000Z,M26536629,FT,10000,514202,DEBIT,BIL/ONL/341858062951/principalmutualfund/8505785861,RFN31065321,2019-08-01
2019-08-01T018:36:07.000Z,M60871976,FT,11345,502857,DEBIT,MMT/IMPS/626443076866/pnbpersonalloan/axis/KIN,RFN53842741,2019-08-01
2019-08-02T003:22:25.000Z,M50599646,FT,50,502807,DEBIT,UPI/712998562793/order/amul/upi,RFN99446358,2019-08-02
2019-08-03T011:02:03.000Z,M29976989,FT,2231,500576,DEBIT,IPS/spencers/303003707594/955355148484/BANGALORE,RFN72599108,2019-08-03
2019-08-03T012:52:21.000Z,M18286331,FT,8832,491744,DEBIT,MMT/IMPS/441123495904/idbihomeloan/axis/HDF,RFN19679307,2019-08-03
2019-08-04T016:12:07.000Z,M51755028,FT,12000,479744,DEBIT,MMT/IMPS/737695731150/rent/axis/SBIN,RFN29135409,2019-08-04
2019-08-04T000:33:30.000Z,M74443345,FT,242,479502,DEBIT,VIN/burgerking/227033744554/707875251944,RFN18697958,2019-08-04
2019-08-05T020:13:53.000Z,M57830548,FT,330,479172,DEBIT,UPI/511989814769/order/uber/ybl,RFN80436941,2019-08-05
2019-08-05T016:11:46.000Z,M95455202,FT,1380,477792,DEBIT,UPI/996116376562/order/bescom/ybl,RFN78990551,2019-08-05
2019-08-07T002:20:16.000Z,M40306716,FT,1500,476292,DEBIT,VIN/indianoil/418855621584/642726353654,RFN59658774,2019-08-07
2019-08-08T005:05:45.000Z,M16170574,FT,200,476092,DEBIT,UPI/203871556591/order/kwalitybazaar/oksbi,RFN50628598,2019-08-08
2019-08-09T010:14:57.000Z,M50550296,FT,1299,474793,DEBIT,UPI/960072239991/order/ionbroadband/okicici,RFN65320795,2019-08-09
2019-08-10T019:53:23.000Z,M84231423,FT,399,474394,DEBIT,UPI/610552077631/order/jio/okicici,RFN18752871,2019-08-10
2019-08-12T021:56:08.000Z,M44303689,FT,3289,471105,DEBIT,VPS/veromoda/379324961288/260014693958/BANGALORE,RFN31095058,2019-08-12
2019-08-12T015:48:51.000Z,M70167978,FT,1110,469995,DEBIT,IPS/beijingbites/876140374767/210625433926/BANGALORE,RFN22584078,2019-08-12
2019-08-15T020:32:08.000Z,M64758529,FT,180,469815,DEBIT,UPI/185218463637/order/amul/oksbi,RFN10414081,2019-08-15
2019-08-18T000:57:43.000Z,M84649300,FT,419,469396,DEBIT,UPI/634318832206/order/1mg/ybl,RFN57661270,2019-08-18
2019-08-18T022:25:19.000Z,M60177681,FT,350,469046,DEBIT,VIN/tatasky/654847883590/701732908746,RFN36989037,2019-08-18
2019-08-22T010:54:17.000Z,M03498191,FT,799,468247,DEBIT,IIN/I-Debit/netflix/016009110554/781282723024,RFN85277325,2019-08-22
2019-08-24T010:55:04.000Z,M62633533,FT,299,467948,DEBIT,VPS/pvr/154496212816/145063968874/BENGALURU,RFN45315957,2019-08-24
2019-08-25T007:20:44.000Z,M08355500,FT,150,467798,DEBIT,UPI/499984570083/order/amul/okhdfcbank,RFN21124555,2019-08-25
2019-08-28T001:27:15.000Z,M33787176,FT,99,467699,DEBIT,UPI/797255473929/order/kwalitybazaar/oksbi,RFN60331086,2019-08-28
2019-08-31T013:28:21.000Z,M88502543,FT,25005,442694,DEBIT,MMT/IMPS/735975766872/axispriviledgeccpmt/axis/SBIN,RFN43272890,2019-08-31
2019-08-31T020:29:48.000Z,M88189491,FT,15542,427152,DEBIT,MMT/IMPS/738383541900/sbieliteccpmt/axis/SIB,RFN26515878,2019-08-31
2019-09-01T023:04:39.000Z,M92318244,FT,120000,547152,CREDIT,salfintechproductsandsolutions September 2019,RFN28477451,2019-09-01
2019-09-01T013:44:27.000Z,M65949117,FT,3567,543585,DEBIT,ACH/maxlifeinsurance/314794451/0109776719,RFN55430936,2019-09-01
2019-09-01T021:19:02.000Z,M83202222,FT,11345,532240,DEBIT,MMT/IMPS/921814235895/pnbpersonalloan/axis/SBIN,RFN93330610,2019-09-01
2019-09-01T010:31:58.000Z,M42511483,FT,15000,517240,DEBIT,BIL/INF/795413312913/motilaloswal/8320017094,RFN81389023,2019-09-01
2019-09-01T003:22:30.000Z,M03520673,FT,10000,507240,DEBIT,BIL/INF/777084983781/principalmutualfund/8832905558,RFN85749752,2019-09-01
2019-09-03T008:01:45.000Z,M33639564,FT,80,507160,DEBIT,UPI/782953571229/order/skrolls/oksbi,RFN33297704,2019-09-03
2019-09-03T016:04:17.000Z,M16341746,FT,100,507060,DEBIT,UPI/634669165754/order/amul/upi,RFN50846814,2019-09-03
2019-09-03T002:42:53.000Z,M80215140,FT,1588,505472,DEBIT,IPS/spencers/755570592526/278073272221/BANGALORE,RFN60540708,2019-09-03
2019-09-03T012:01:31.000Z,M82610329,FT,8832,496640,DEBIT,MMT/IMPS/138053016152/idbihomeloan/axis/BLR,RFN45752389,2019-09-03
2019-09-04T018:18:10.000Z,M12666070,FT,12000,484640,DEBIT,MMT/IMPS/154684492582/rent/axis/SBIN,RFN88142810,2019-09-04
2019-09-05T012:05:02.000Z,M45940506,FT,898,483742,DEBIT,VIN/beijingbites/832132061341/929978151354,RFN19105981,2019-09-05
2019-09-05T021:44:14.000Z,M52825633,FT,3500,487242,CREDIT,BIL/BPAY/388471860270/994302139330/4602695167,RFN78717754,2019-09-05
2019-09-05T005:25:30.000Z,M24939938,FT,1680,485562,DEBIT,UPI/196480870961/order/bescom/oksbi,RFN24341490,2019-09-05
2019-09-06T019:53:12.000Z,M68233672,FT,459,485103,DEBIT,VPS/pvr/551347732317/408346400486/BLR,RFN31923025,2019-09-06
2019-09-08T008:40:47.000Z,M26678455,FT,100,485003,DEBIT,UPI/621660183953/order/kwalitybazaar/okhdfcbank,RFN07948971,2019-09-08
2019-09-08T023:48:55.000Z,M58113111,FT,80,484923,DEBIT,UPI/127308936834/order/amul/upi,RFN02830317,2019-09-08
2019-09-09T003:57:36.000Z,M86390411,FT,1299,483624,DEBIT,UPI/164411570299/order/ionbroadband/okhdfcbank,RFN67865068,2019-09-09
2019-09-12T010:40:18.000Z,M94446032,FT,420,483204,DEBIT,VPS/eatfit/011565646989/482533073787/bangalore,RFN13852869,2019-09-12
2019-09-12T002:50:13.000Z,M87200196,FT,14394,468810,DEBIT,IPS/cleartrip/102231357284/650012271056/BANGALORE,RFN06846441,2019-09-12
2019-09-15T011:47:41.000Z,M36755090,FT,150,468660,DEBIT,UPI/012768580357/order/bblunt/ybl,RFN19390352,2019-09-15
2019-09-17T007:14:47.000Z,M25268446,FT,1400,467260,DEBIT,VIN/bluo/477342536874/014432028238,RFN60134812,2019-09-17
2019-09-18T009:18:37.000Z,M00923724,FT,419,466841,DEBIT,UPI/274241920271/order/chaipoint/okicici,RFN09114197,2019-09-18
2019-09-18T022:41:32.000Z,M12728572,FT,350,466491,DEBIT,VIN/tatasky/003967408644/189949352552,RFN89636036,2019-09-18
2019-09-22T017:41:27.000Z,M24046385,FT,799,465692,DEBIT,IIN/I-Debit/netflix/335063981671/715618416707,RFN29440787,2019-09-22
2019-09-24T021:23:27.000Z,M68247886,FT,399,465293,DEBIT,VPS/pvr/673832170843/192133267653/Begaluru,RFN78062595,2019-09-24
2019-09-24T021:50:13.000Z,M98117838,FT,129,465164,DEBIT,UPI/390796438356/order/uber/okhdfcbank,RFN92755891,2019-09-24
2019-09-28T022:17:42.000Z,M23094394,FT,702,464462,DEBIT,UPI/058186755678/order/kwalitybazaar/okhdfcbank,RFN08391132,2019-09-28
2019-09-30T018:58:00.000Z,M33781758,FT,25005,439457,DEBIT,MMT/IMPS/288426415001/axispriviledgeccpmt/axis/KIN,RFN18825215,2019-09-30
2019-09-30T001:26:00.000Z,M02619175,FT,205,439252,DEBIT,UPI/302269046269/order/amazon/ybl,RFN70772759,2019-09-30
2019-09-30T022:59:45.000Z,M99217770,FT,15542,423710,DEBIT,MMT/IMPS/970406058049/sbieliteccpmt/axis/BLR,RFN12015874,2019-09-30
2019-09-30T020:49:58.000Z,M01521835,ATM,10000,413710,DEBIT,ATM/GVQRD453/CASH WDL/2019-09-30,RFN22352085,2019-09-30
2019-10-01T013:16:08.000Z,M88881956,FT,120000,533710,CREDIT,salfintechproductsandsolutions October 2019,RFN16471456,2019-10-01
2019-10-01T021:34:05.000Z,M15955512,FT,3567,530143,DEBIT,ACH/maxlifeinsurance/230561244/7726718697,RFN25359001,2019-10-01
2019-10-01T016:30:20.000Z,M39688204,FT,11345,518798,DEBIT,MMT/IMPS/633796622912/pnbpersonalloan/axis/BLR,RFN58449584,2019-10-01
2019-10-01T020:39:26.000Z,M03921428,FT,9000,509798,DEBIT,BIL/ONL/949007405855/motilaloswal/7632023445,RFN67586569,2019-10-01
2019-10-01T020:40:40.000Z,M47621759,FT,15000,494798,DEBIT,BIL/BPAY/029836277882/principalmutualfund/9213477142,RFN39915367,2019-10-01
2019-10-02T003:49:20.000Z,M88532222,FT,560,494238,DEBIT,UPI/063071629084/order/kfc/okicici,RFN32508948,2019-10-02
2019-10-03T022:28:46.000Z,M20627434,FT,560,493678,DEBIT,IPS/pvr/959214951204/111612888472/BANGALORE,RFN43133880,2019-10-03
2019-10-03T004:03:25.000Z,M22406774,FT,8832,484846,DEBIT,MMT/IMPS/340275488020/idbihomeloan/axis/BLR,RFN17769515,2019-10-03
2019-10-04T018:36:13.000Z,M44171478,FT,12000,472846,DEBIT,MMT/IMPS/114251099794/rent/axis/HDF,RFN10023293,2019-10-04
2019-10-04T019:57:20.000Z,M93635908,FT,3500,469346,DEBIT,VIN/veromoda/534882050324/586587578233,RFN32372216,2019-10-04
2019-10-04T018:08:15.000Z,M93490861,FT,7500,461846,DEBIT,VIN/adidas/231571851958/092226664628,RFN47461605,2019-10-04
2019-10-04T000:56:14.000Z,M64700810,FT,280,461566,DEBIT,UPI/072374090733/order/uber/oksbi,RFN10195567,2019-10-04
2019-10-05T014:59:54.000Z,M15929257,FT,1140,460426,DEBIT,UPI/758840332149/order/bescom/okhdfcbank,RFN88067073,2019-10-05
2019-10-07T013:48:37.000Z,M50560568,FT,2000,458426,DEBIT,VIN/indianoil/595970721592/422407469283,RFN85502310,2019-10-07
2019-10-08T006:14:56.000Z,M34822687,FT,1200,457226,DEBIT,UPI/495634862114/order/kwalitybazaar/okicici,RFN57005831,2019-10-08
2019-10-10T004:33:12.000Z,M79653850,FT,1299,455927,DEBIT,UPI/343297749779/order/ionbroadband/oksbi,RFN11295484,2019-10-10
2019-10-12T003:10:29.000Z,M41272146,FT,130,455797,DEBIT,UPI/614036325609/order/amul/oksbi,RFN88045602,2019-10-12
2019-10-12T000:05:11.000Z,M60384975,FT,1510,454287,DEBIT,IPS/beijingbites/688696122804/020201117286/BANGALORE,RFN49049680,2019-10-12
2019-10-12T023:09:21.000Z,M28379306,FT,1240,453047,DEBIT,UPI/354834808087/order/sugar/okhdfcbank,RFN11343609,2019-10-12
2019-10-13T001:18:42.000Z,M81446552,FT,6599,446448,DEBIT,VIN/nolimmits/974174758458/837141338191,RFN46851396,2019-10-13
2019-10-13T023:46:32.000Z,M77542651,FT,830,445618,DEBIT,UPI/193573393488/order/uber/ybl,RFN77470685,2019-10-13
2019-10-14T001:48:14.000Z,M74606091,FT,180,445438,DEBIT,UPI/427694552203/order/amul/ybl,RFN62401650,2019-10-14
2019-10-14T001:50:02.000Z,M77347914,FT,100,445338,DEBIT,UPI/870393589565/order/amul/okhdfcbank,RFN35552316,2019-10-14
2019-10-18T008:45:48.000Z,M80234983,FT,350,444988,DEBIT,VIN/tatasky/044548172067/675707990072,RFN15324218,2019-10-18
2019-10-22T002:46:13.000Z,M50059289,FT,799,444189,DEBIT,IIN/I-Debit/netflix/856309311344/850838400090,RFN45236342,2019-10-22
2019-10-24T012:08:52.000Z,M84482067,FT,299,443890,DEBIT,VPS/pvr/712181493437/821259292551/bangalore,RFN71445478,2019-10-24
2019-10-25T012:19:38.000Z,M32578168,FT,270,443620,DEBIT,UPI/703233627398/order/swiggy/ybl,RFN25953441,2019-10-25
2019-10-26T012:10:59.000Z,M58769962,FT,2700,440920,DEBIT,VIN/indianoil/726697332976/309872062958,RFN18274261,2019-10-26
2019-10-26T003:49:07.000Z,M01900191,FT,2021,442941,CREDIT,BIL/ONL/204700880206/233488841023/4034413986,RFN98108433,2019-10-26
2019-10-28T012:46:37.000Z,M18690724,FT,2001,440940,DEBIT,UPI/261559359162/order/decathlon/ybl,RFN12123065,2019-10-28
2019-10-28T004:06:24.000Z,M04367201,FT,1900,439040,DEBIT,IPS/dentistclinic/124091096267/501885103096/BANGALORE,RFN75466541,2019-10-28
2019-10-31T000:40:11.000Z,M65272443,FT,25005,414035,DEBIT,MMT/IMPS/344207222537/axispriviledgeccpmt/axis/SBIN,RFN49211298,2019-10-31
2019-10-31T014:04:25.000Z,M42620300,FT,15542,398493,DEBIT,MMT/IMPS/582567184252/sbieliteccpmt/axis/SBIN,RFN48620608,2019-10-31
2019-11-01T011:41:55.000Z,M10000499,FT,120000,518493,CREDIT,salfintechproductsandsolutions November 2019,RFN31612044,2019-11-01
2019-11-01T002:23:38.000Z,M77292037,FT,3567,514926,DEBIT,ACH/maxlifeinsurance/366291410/2419440309,RFN31436244,2019-11-01
2019-11-01T012:17:41.000Z,M64893453,FT,11345,503581,DEBIT,MMT/IMPS/960278606039/pnbpersonalloan/axis/KIN,RFN21716587,2019-11-01
2019-11-01T013:56:49.000Z,M52695806,FT,8000,495581,DEBIT,BIL/INF/270668952098/motilaloswal/8131394092,RFN77277817,2019-11-01
2019-11-01T003:55:50.000Z,M43560471,FT,8000,487581,DEBIT,BIL/INF/747947538321/principalmutualfund/3751390227,RFN93828791,2019-11-01
2019-11-02T019:28:26.000Z,M49732558,FT,70,487511,DEBIT,UPI/983240774750/order/amul/upi,RFN49807883,2019-11-02
2019-11-03T000:06:29.000Z,M99748985,FT,2730,484781,DEBIT,IPS/spencers/043065309364/418600324539/BANGALORE,RFN46877844,2019-11-03
2019-11-03T005:31:00.000Z,M66510102,FT,8832,475949,DEBIT,MMT/IMPS/961163086445/idbihomeloan/axis/BLR,RFN94250634,2019-11-03
2019-11-04T000:14:43.000Z,M67867418,FT,12000,463949,DEBIT,MMT/IMPS/492591531215/rent/axis/HDF,RFN90208174,2019-11-04
2019-11-04T000:05:50.000Z,M43421243,FT,890,463059,DEBIT,VIN/kfc/968841269026/808855065243,RFN92105754,2019-11-04
2019-11-04T020:38:45.000Z,M45676074,FT,799,462260,DEBIT,VIN/bblunt/926523081792/456465638986,RFN30397304,2019-11-04
2019-11-05T003:41:54.000Z,M06233834,FT,2999,459261,DEBIT,UPI/602065075641/order/indianoil/okicici,RFN86722483,2019-11-05
2019-11-05T001:38:56.000Z,M53708322,FT,1654,457607,DEBIT,UPI/432001327052/order/bescom/okaxis,RFN30652890,2019-11-05
2019-11-07T016:18:11.000Z,M38494709,FT,1500,456107,DEBIT,VIN/indianoil/026032011194/756430692336,RFN20843745,2019-11-07
2019-11-08T002:16:09.000Z,M70836695,FT,240,455867,DEBIT,UPI/057995852191/order/kwalitybazaar/upi,RFN14804990,2019-11-08
2019-11-11T013:23:28.000Z,M56744436,FT,1299,454568,DEBIT,UPI/311961838375/order/ionbroadband/okaxis,RFN76211475,2019-11-11
2019-11-10T014:26:14.000Z,M57632001,FT,399,454169,DEBIT,UPI/446895350790/order/jio/okaxis,RFN10064341,2019-11-10
2019-11-12T012:28:31.000Z,M49874657,FT,333,453836,DEBIT,UPI/388633889416/order/uber/upi,RFN83020786,2019-11-12
2019-11-12T006:56:05.000Z,M50127518,FT,2508,451328,DEBIT,IPS/gilly's/814641019170/050430083854/BANGALORE,RFN00956793,2019-11-12
2019-11-12T005:45:22.000Z,M84283525,FT,339,450989,DEBIT,UPI/327956570122/order/uber/ybl,RFN64846498,2019-11-12
2019-11-15T014:17:38.000Z,M80345110,FT,130,450859,DEBIT,UPI/839763395731/order/1mg/ybl,RFN55999850,2019-11-15
2019-11-15T001:37:02.000Z,M02327863,FT,3019,453878,CREDIT,BIL/INF/357795946103/94320092/9976241575,RFN61673393,2019-11-15
2019-11-18T004:00:32.000Z,M92198312,FT,2019,451859,DEBIT,UPI/044340743023/order/oriflame/okaxis,RFN65390340,2019-11-18
2019-11-18T019:05:41.000Z,M58316713,FT,350,451509,DEBIT,VIN/tatasky/905109508064/001092202209,RFN65290723,2019-11-18
2019-11-22T001:50:51.000Z,M02866602,FT,799,450710,DEBIT,IIN/I-Debit/netflix/085940933461/343123706079,RFN04087770,2019-11-22
2019-11-24T004:42:46.000Z,M34619828,FT,540,450170,DEBIT,VPS/pvr/720916979983/358946558103/BANGALORE,RFN29182455,2019-11-24
2019-11-25T004:50:13.000Z,M40063314,FT,150,450020,DEBIT,UPI/476846655534/order/amul/okaxis,RFN19399462,2019-11-25
2019-11-26T021:10:57.000Z,M65650543,FT,3500,446520,DEBIT,VIN/tonique/175529158296/115857029819,RFN64318251,2019-11-26
2019-11-26T002:07:37.000Z,M72688211,FT,2034,444486,DEBIT,VIN/spencer/541106408941/481798636178,RFN57238701,2019-11-26
2019-11-28T007:31:04.000Z,M50930323,FT,1900,442586,DEBIT,UPI/986518176702/order/dentistclinic/oksbi,RFN86982639,2019-11-28
2019-11-30T022:19:25.000Z,M71499841,FT,25005,417581,DEBIT,MMT/IMPS/127521599323/axispriviledgeccpmt/axis/BLR,RFN42491973,2019-11-30
2019-11-30T013:02:29.000Z,M00450984,FT,15542,402039,DEBIT,MMT/IMPS/460619214833/sbieliteccpmt/axis/SBIN,RFN34884058,2019-11-30
2019-12-01T012:04:54.000Z,M33626490,FT,120000,522039,CREDIT,salfintechproductsandsolutions December 2019,RFN72502543,2019-12-01
2019-12-01T007:33:34.000Z,M27667175,FT,3567,518472,DEBIT,ACH/maxlifeinsurance/695947860/9851787200,RFN65698635,2019-12-01
2019-12-01T002:49:30.000Z,M16588037,FT,11345,507127,DEBIT,MMT/IMPS/833882559279/pnbpersonalloan/axis/SBIN,RFN09153095,2019-12-01
2019-12-01T014:35:51.000Z,M83025233,FT,12000,495127,DEBIT,BIL/ONL/157871312742/motilaloswal/0272561819,RFN36181795,2019-12-01
2019-12-01T020:34:55.000Z,M44365408,FT,12000,483127,DEBIT,BIL/ONL/403788046349/principalmutualfund/7169778485,RFN16328504,2019-12-01
2019-12-02T012:55:06.000Z,M06990276,FT,80,483047,DEBIT,UPI/213565387665/order/amul/okaxis,RFN39120475,2019-12-02
2019-12-03T014:03:58.000Z,M23355702,FT,1409,481638,DEBIT,IPS/spencers/044621951563/946423853670/BANGALORE,RFN12568553,2019-12-03
2019-12-03T010:22:00.000Z,M11035240,FT,8832,472806,DEBIT,MMT/IMPS/185939335319/idbihomeloan/axis/HDF,RFN92790806,2019-12-03
2019-12-04T009:48:00.000Z,M14824633,FT,12000,460806,DEBIT,MMT/IMPS/676061255849/rent/axis/SBIN,RFN05868036,2019-12-04
2019-12-04T015:12:05.000Z,M13585293,FT,242,460564,DEBIT,VIN/burgerking/253857385659/356509105592,RFN18703070,2019-12-04
2019-12-04T010:07:04.000Z,M72208167,FT,597,459967,DEBIT,UPI/774587275198/order/cafecofffeeday/ybl,RFN42021190,2019-12-04
2019-12-05T011:16:55.000Z,M16080173,FT,540,459427,DEBIT,UPI/033681395640/order/kwalitybazaar/ybl,RFN60503215,2019-12-05
2019-12-05T015:06:14.000Z,M40565286,FT,1220,458207,DEBIT,UPI/551194679742/order/bescom/upi,RFN10746394,2019-12-05
2019-12-07T019:14:59.000Z,M41166627,FT,1430,456777,DEBIT,VIN/indianoil/733852922229/210942332720,RFN07251396,2019-12-07
2019-12-08T022:54:19.000Z,M07804259,FT,200,456577,DEBIT,UPI/591034868556/order/kwalitybazaar/okhdfcbank,RFN39469194,2019-12-08
2019-12-15T021:59:34.000Z,M06343753,FT,4299,460876,CREDIT,BIL/BPAY/154369535425/8884492110/1826223070,RFN85634236,2019-12-15
2019-12-09T023:32:36.000Z,M62104542,FT,1299,459577,DEBIT,UPI/236604555691/order/ionbroadband/upi,RFN89818624,2019-12-09
2019-12-10T023:53:30.000Z,M32865788,ATM,2500,457077,DEBIT,ATM/AINUW540/CASH WDL/2019-12-10,RFN76643612,2019-12-10
2019-12-11T011:41:12.000Z,M09941346,FT,430,456647,DEBIT,VPS/pvr/344614339063/040855095448/Begaluru,RFN00193717,2019-12-11
2019-12-12T016:22:01.000Z,M75612555,FT,743,455904,DEBIT,IIN/I-Debit/smokehouse/354174272248/279810047242,RFN78391667,2019-12-12
2019-12-12T015:36:14.000Z,M44912100,FT,500,455404,DEBIT,IPS/vedantsaxena/800726640141/401361046315/BANGALORE,RFN22265277,2019-12-12
2019-12-15T016:34:43.000Z,M18804998,FT,280,455124,DEBIT,UPI/258343158253/order/amul/okicici,RFN73360318,2019-12-15
2019-12-18T014:48:58.000Z,M24781840,FT,399,454725,DEBIT,UPI/567491279993/order/hairspeak/okicici,RFN93388020,2019-12-18
2019-12-18T019:53:18.000Z,M88955608,FT,350,454375,DEBIT,VIN/tatasky/878275363467/961894588496,RFN50215153,2019-12-18
2019-12-22T003:42:20.000Z,M39942504,FT,799,453576,DEBIT,IIN/I-Debit/netflix/532336732693/775370724894,RFN03179082,2019-12-22
2019-12-24T011:32:50.000Z,M90918086,FT,299,453277,DEBIT,VPS/pvr/761454067419/649743220112/BANGALORE,RFN47067174,2019-12-24
2019-12-25T003:05:21.000Z,M09269411,FT,340,452937,DEBIT,UPI/623143431867/order/zomato/upi,RFN95162832,2019-12-25
2019-12-28T004:50:27.000Z,M36461389,FT,4999,447938,DEBIT,VPS/h&m/890337642478/754229013841/bangalore,RFN92566736,2019-12-28
2019-12-28T021:10:35.000Z,M98312530,FT,1900,446038,DEBIT,UPI/141372425366/order/dentistclinic/upi,RFN35697943,2019-12-28
2019-12-31T006:41:47.000Z,M37488687,FT,25005,421033,DEBIT,MMT/IMPS/571772572655/axispriviledgeccpmt/axis/HDF,RFN61540588,2019-12-31
2019-12-31T000:45:52.000Z,M32218510,FT,15542,405491,DEBIT,MMT/IMPS/916412439336/sbieliteccpmt/axis/BLR,RFN46201855,2019-12-31
2020-01-01T005:23:56.000Z,M40413235,FT,120000,525491,CREDIT,salfintechproductsandsolutions January 2020,RFN81098055,2020-01-01
2020-01-01T010:54:48.000Z,M31991931,FT,3567,521924,DEBIT,ACH/maxlifeinsurance/999602104/6285572907,RFN19230710,2020-01-01
2020-01-01T007:02:09.000Z,M57590117,FT,11345,510579,DEBIT,MMT/IMPS/990643874668/pnbpersonalloan/axis/KIN,RFN82580694,2020-01-01
2020-01-01T023:44:05.000Z,M72842143,FT,15000,495579,DEBIT,BIL/INF/459018344876/motilaloswal/2606266332,RFN20667250,2020-01-01
2020-01-02T015:02:40.000Z,M94719912,FT,1209,494370,DEBIT,UPI/189983285874/order/kfc/upi,RFN56538197,2020-01-02
2020-01-03T003:54:42.000Z,M70745296,FT,1939,492431,DEBIT,IPS/spencers/268468949035/481818484940/BANGALORE,RFN60455144,2020-01-03
2020-01-03T004:52:19.000Z,M22359474,FT,8832,483599,DEBIT,MMT/IMPS/943733798147/idbihomeloan/axis/SBIN,RFN01891361,2020-01-03
2020-01-04T010:50:58.000Z,M02492321,FT,607,484206,CREDIT,BIL/INF/347763866101/88844432292110/2572665228,RFN47299844,2020-01-04
2020-01-04T021:14:45.000Z,M56955654,FT,12000,472206,DEBIT,MMT/IMPS/661155866723/rent/axis/SBIN,RFN86578524,2020-01-04
2020-01-04T019:44:19.000Z,M00662890,FT,3999,468207,DEBIT,VIN/h&m/889996366851/131081497523,RFN26872406,2020-01-04
2020-01-04T013:35:32.000Z,M90886701,FT,1999,466208,DEBIT,VIN/catwalk/282881398748/282916397981,RFN03055777,2020-01-04
2020-01-05T021:16:14.000Z,M64460210,FT,880,465328,DEBIT,UPI/760120090789/order/uber/okicici,RFN16845816,2020-01-05
2020-01-05T019:16:22.000Z,M02545368,FT,8902,456426,DEBIT,UPI/244484834626/order/gilly's/okhdfcbank,RFN20632883,2020-01-05
2020-01-05T000:36:37.000Z,M79137584,FT,640,455786,DEBIT,UPI/477358316688/order/uber/ybl,RFN57976874,2020-01-05
2020-01-05T020:47:16.000Z,M89769733,FT,1380,454406,DEBIT,UPI/938678161871/order/bescom/ybl,RFN51935122,2020-01-05
2020-01-07T001:06:13.000Z,M02142619,FT,20208,434198,DEBIT,VIN/cleartrip/949331645434/821449713522,RFN77240239,2020-01-07
2020-01-08T021:46:11.000Z,M60181596,FT,4999,429199,DEBIT,VIN/americantourister/848855648004/833559604917,RFN04396548,2020-01-08
2020-01-09T000:45:44.000Z,M73516204,FT,1299,427900,DEBIT,UPI/912467426102/order/ionbroadband/okicici,RFN50256247,2020-01-09
2020-01-12T004:47:24.000Z,M27762200,FT,3994,423906,DEBIT,VPS/veromoda/139738005725/147543832624/Begaluru,RFN80574435,2020-01-12
2020-01-12T023:12:54.000Z,M78162515,FT,1410,422496,DEBIT,UPI/350485024602/order/kfc/upi,RFN44168495,2020-01-12
2020-01-15T013:04:57.000Z,M89837689,FT,480,422016,DEBIT,UPI/954230653459/order/stonedmonkey/ybl,RFN22070642,2020-01-15
2020-01-18T004:46:07.000Z,M79632935,FT,750,421266,DEBIT,UPI/760496938083/order/zomato/okaxis,RFN16169921,2020-01-18
2020-01-18T019:38:30.000Z,M75880541,FT,350,420916,DEBIT,VIN/tatasky/463998087204/713263527288,RFN41817958,2020-01-18
2020-01-22T022:13:51.000Z,M62155114,FT,799,420117,DEBIT,IIN/I-Debit/netflix/054103696250/496158090485,RFN31387522,2020-01-22
2020-01-23T006:42:44.000Z,M36801610,FT,189,419928,DEBIT,VPS/pvr/405951983757/650052227399/BANGALORE,RFN86041311,2020-01-23
2020-01-24T005:00:56.000Z,M01965333,FT,2001,421929,CREDIT,BIL/ONL/313240550116/00333954322234955/0874162837,RFN89452128,2020-01-24
2020-01-25T011:20:32.000Z,M95782208,FT,1440,420489,DEBIT,UPI/209734506127/order/amazon/oksbi,RFN80086074,2020-01-25
2020-01-28T022:37:03.000Z,M87440994,FT,1900,418589,DEBIT,UPI/128513503476/order/dentistclinic/oksbi,RFN75335305,2020-01-28
2020-01-28T016:45:44.000Z,M81134261,FT,399,418190,DEBIT,UPI/639956866504/order/kwalitybazaar/oksbi,RFN27315809,2020-01-28
2020-01-31T005:57:25.000Z,M03487432,FT,25005,393185,DEBIT,MMT/IMPS/997062843860/axispriviledgeccpmt/axis/BLR,RFN99069546,2020-01-31
2020-01-31T004:18:20.000Z,M54074604,FT,15542,377643,DEBIT,MMT/IMPS/827091785156/sbieliteccpmt/axis/HDF,RFN86891816,2020-01-31
2020-02-01T019:21:57.000Z,M10429505,FT,120000,497643,CREDIT,salfintechproductsandsolutions February 2020,RFN98700058,2020-02-01
2020-02-01T016:39:43.000Z,M28942076,FT,3567,494076,DEBIT,ACH/maxlifeinsurance/933301596/1711241783,RFN98884724,2020-02-01
2020-02-01T009:21:10.000Z,M48820542,FT,11345,482731,DEBIT,MMT/IMPS/508740280004/pnbpersonalloan/axis/SBIN,RFN16431109,2020-02-01
2020-02-01T023:26:23.000Z,M86336051,FT,5000,477731,DEBIT,BIL/ONL/734577774471/motilaloswal/5584945639,RFN21626601,2020-02-01
2020-02-01T005:18:26.000Z,M20961632,FT,5000,472731,DEBIT,BIL/BPAY/310394616548/principalmutualfund/9527313542,RFN00732254,2020-02-01
2020-02-02T023:11:04.000Z,M35876065,FT,670,472061,DEBIT,UPI/773761650530/order/cafecofeeday/upi,RFN27125231,2020-02-02
2020-02-03T015:14:08.000Z,M45379755,FT,3100,468961,DEBIT,IPS/spencers/203292189198/115600024074/BANGALORE,RFN99373977,2020-02-03
2020-02-03T000:05:55.000Z,M75235826,FT,8832,460129,DEBIT,MMT/IMPS/620078721386/idbihomeloan/axis/SBIN,RFN67100008,2020-02-03
2020-02-04T022:09:54.000Z,M69558000,FT,12000,448129,DEBIT,MMT/IMPS/631884517271/rent/axis/HDF,RFN03445455,2020-02-04
2020-02-04T013:31:13.000Z,M46456444,FT,550,447579,DEBIT,VIN/kfc/558503187757/808699022108,RFN83821333,2020-02-04
2020-02-05T011:09:47.000Z,M14660691,FT,1380,446199,DEBIT,UPI/566207735530/order/bescom/oksbi,RFN18139905,2020-02-05
2020-02-07T012:15:56.000Z,M79632480,FT,2500,443699,DEBIT,VIN/indianoil/128705154424/102809382241,RFN84681919,2020-02-07
2020-02-08T015:08:09.000Z,M02235580,FT,1200,442499,DEBIT,UPI/509748498923/order/kwalitybazaar/ybl,RFN06918365,2020-02-08
2020-02-09T010:57:50.000Z,M74008304,FT,1299,441200,DEBIT,UPI/603086696198/order/ionbroadband/upi,RFN54230240,2020-02-09
2020-02-10T000:49:30.000Z,M26213031,FT,399,440801,DEBIT,UPI/318332395501/order/jio/okhdfcbank,RFN26848316,2020-02-10
2020-02-12T001:59:26.000Z,M18642655,FT,1800,439001,DEBIT,UPI/440223967522/order/gilly's/okicici,RFN19477061,2020-02-12
2020-02-15T017:10:55.000Z,M73218251,FT,180,438821,DEBIT,UPI/337657059166/order/amul/oksbi,RFN79331741,2020-02-15
2020-02-18T000:18:25.000Z,M40247421,FT,160,438661,DEBIT,UPI/486644397853/order/1mg/upi,RFN25575664,2020-02-18
2020-02-18T006:48:41.000Z,M39727142,FT,350,438311,DEBIT,VIN/tatasky/854683612872/338574491549,RFN29073531,2020-02-18
2020-02-22T021:41:58.000Z,M44143145,FT,799,437512,DEBIT,IIN/I-Debit/netflix/973614035276/213144213182,RFN51826825,2020-02-22
2020-02-25T022:45:12.000Z,M72226579,FT,50,437462,DEBIT,UPI/842988673416/order/amul/okaxis,RFN90652769,2020-02-25
2020-02-28T002:50:21.000Z,M14314658,FT,310,437152,DEBIT,UPI/118627530802/order/uber/okicici,RFN45918258,2020-02-28
2020-02-28T011:33:37.000Z,M08717204,FT,1900,435252,DEBIT,UPI/740098064596/order/dentistclinic/ybl,RFN87971304,2020-02-28
2020-02-28T004:25:04.000Z,M89196503,FT,330,434922,DEBIT,UPI/337485710123/order/uber/ybl,RFN70881160,2020-02-28
2020-02-28T016:47:43.000Z,M22804899,FT,99,434823,DEBIT,UPI/871751565517/order/kwalitybazaar/ybl,RFN12562230,2020-02-28
2020-02-28T000:21:06.000Z,M39449145,FT,25005,409818,DEBIT,MMT/IMPS/318722422168/axispriviledgeccpmt/axis/SBIN,RFN88080911,2020-02-28
2020-02-28T021:58:15.000Z,M29480522,FT,15542,394276,DEBIT,MMT/IMPS/611487035873/sbieliteccpmt/axis/SBIN,RFN74204031,2020-02-28
2020-03-01T023:32:11.000Z,M37934741,FT,120000,514276,CREDIT,salfintechproductsandsolutions March 2020,RFN60584564,2020-03-01
2020-03-01T003:11:28.000Z,M91293489,FT,3567,510709,DEBIT,ACH/maxlifeinsurance/916606737/3815996136,RFN50524814,2020-03-01
2020-03-01T003:19:19.000Z,M96415767,FT,11345,499364,DEBIT,MMT/IMPS/209168323112/pnbpersonalloan/axis/HDF,RFN58724485,2020-03-01
2020-03-01T004:23:31.000Z,M26666350,FT,11000,488364,DEBIT,BIL/INF/923427609951/motilaloswal/9247363815,RFN72668782,2020-03-01
2020-03-01T018:22:12.000Z,M28304342,FT,10500,477864,DEBIT,BIL/BPAY/191483715304/principalmutualfund/9456799221,RFN63786071,2020-03-01
2020-03-02T011:41:41.000Z,M33850592,FT,240,477624,DEBIT,UPI/083192639329/order/amul/okhdfcbank,RFN98077240,2020-03-02
2020-03-03T021:23:21.000Z,M49926118,FT,1536,476088,DEBIT,IPS/bigbasket/418357876764/188763257712/BANGALORE,RFN35712392,2020-03-03
2020-03-03T021:48:50.000Z,M79613997,FT,8832,467256,DEBIT,MMT/IMPS/664909515720/idbihomeloan/axis/HDF,RFN75480132,2020-03-03
2020-03-04T008:50:13.000Z,M93753428,FT,12000,455256,DEBIT,MMT/IMPS/521597814826/rent/axis/BLR,RFN02169547,2020-03-04
2020-03-04T000:18:07.000Z,M80788344,FT,242,455014,DEBIT,UPI/117007814457/order/leongrill/okaxis,RFN65783583,2020-03-04
2020-03-05T011:14:29.000Z,M41131992,FT,1561,453453,DEBIT,UPI/713878713153/order/bescom/okaxis,RFN14784139,2020-03-05
2020-03-07T004:35:16.000Z,M15362333,FT,1500,451953,DEBIT,VIN/indianoil/093376950576/745761318332,RFN70232453,2020-03-07
2020-03-08T019:39:17.000Z,M09772774,FT,220,451733,DEBIT,UPI/713975686952/order/sriganeshmedical/oksbi,RFN72673648,2020-03-08
2020-03-09T013:04:24.000Z,M16304634,FT,1299,450434,DEBIT,UPI/824595521441/order/ionbroadband/okicici,RFN66195185,2020-03-09
2020-03-11T015:48:25.000Z,M77640991,FT,3006,453440,CREDIT,BIL/INF/076397796681/23435678032/2152473176,RFN05932409,2020-03-11
2020-03-12T013:05:58.000Z,M80848771,FT,13999,439441,DEBIT,VPS/amazon/201739149062/546848973443/BLR,RFN81606427,2020-03-12
2020-03-12T008:03:44.000Z,M25524044,FT,310,439131,DEBIT,IIN/I-Debit/a2b/790766363216/743797965893,RFN89397162,2020-03-12
2020-03-15T007:19:26.000Z,M71142804,FT,180,438951,DEBIT,UPI/259073433958/order/amul/upi,RFN63059322,2020-03-15
2020-03-18T010:27:25.000Z,M79776458,FT,1400,437551,DEBIT,UPI/051987621048/order/myntra/upi,RFN43635781,2020-03-18
2020-03-18T018:01:47.000Z,M95705231,FT,350,437201,DEBIT,VIN/tatasky/108213074202/736882786926,RFN21276627,2020-03-18
2020-03-21T017:27:00.000Z,M04544327,FT,850,436351,DEBIT,VIN/bblunt/706377882251/510835057015,RFN67061627,2020-03-21
2020-03-22T012:27:56.000Z,M91291004,FT,799,435552,DEBIT,IIN/I-Debit/netflix/279974130781/023417083229,RFN12885483,2020-03-22
2020-03-28T002:13:53.000Z,M90129503,FT,29,435523,DEBIT,UPI/461004473354/order/kwalitybazaar/ybl,RFN07125898,2020-03-28
2020-03-31T011:38:37.000Z,M17314165,FT,25005,410518,DEBIT,MMT/IMPS/516154616612/axispriviledgeccpmt/axis/KIN,RFN55536555,2020-03-31
2020-03-31T018:19:47.000Z,M12493937,FT,15542,394976,DEBIT,MMT/IMPS/620151487214/sbieliteccpmt/axis/BLR,RFN41300827,2020-03-31
2020-04-01T003:38:43.000Z,M06304563,FT,120000,514976,CREDIT,salfintechproductsandsolutions April 2020,RFN76781297,2020-04-01
2020-04-01T004:42:36.000Z,M54301724,FT,3567,511409,DEBIT,ACH/maxlifeinsurance/013961668/6892928485,RFN73869080,2020-04-01
2020-04-01T018:09:41.000Z,M64490335,FT,11345,500064,DEBIT,MMT/IMPS/220754159377/pnbpersonalloan/axis/BLR,RFN79847490,2020-04-01
2020-04-01T011:29:06.000Z,M64394439,FT,8000,492064,DEBIT,BIL/ONL/156058583600/motilaloswal/3770843187,RFN00556453,2020-04-01
2020-04-01T019:57:24.000Z,M58626357,FT,15500,476564,DEBIT,BIL/ONL/404408695938/principalmutualfund/5206339588,RFN70040636,2020-04-01
2020-04-02T008:52:02.000Z,M46500388,FT,670,475894,DEBIT,UPI/249411753104/order/mrgoofy's/okhdfcbank,RFN31497952,2020-04-02
2020-04-03T015:15:33.000Z,M08712403,FT,1983,473911,DEBIT,IPS/spencers/554989609784/410771689860/BANGALORE,RFN19340097,2020-04-03
2020-04-03T023:21:07.000Z,M17344862,FT,8832,465079,DEBIT,MMT/IMPS/987054211038/idbihomeloan/axis/SIB,RFN01476083,2020-04-03
2020-04-04T005:04:15.000Z,M04467623,FT,12000,453079,DEBIT,MMT/IMPS/710212906915/rent/axis/KIN,RFN95685576,2020-04-04
2020-04-04T017:01:46.000Z,M87117195,FT,667,452412,DEBIT,UPI/742353897417/order/zomato/oksbi,RFN03500966,2020-04-04
2020-04-05T001:15:32.000Z,M27759685,FT,560,451852,DEBIT,UPI/878630963487/order/uber/okaxis,RFN48010058,2020-04-05
2020-04-05T017:48:43.000Z,M58668189,FT,880,450972,DEBIT,UPI/445583641422/order/bescom/oksbi,RFN53334010,2020-04-05
2020-04-05T010:20:06.000Z,M49723520,FT,2016,452988,CREDIT,BIL/BPAY/820359843473/435456745323234353/3149233947,RFN09171754,2020-04-05
2020-04-07T001:53:39.000Z,M78294747,FT,2000,450988,DEBIT,VIN/indianoil/110470897368/469533058352,RFN85218644,2020-04-07
2020-04-08T006:11:18.000Z,M38299060,FT,1299,449689,DEBIT,UPI/082134138561/order/skybags/okicici,RFN74523818,2020-04-08
2020-04-09T002:03:49.000Z,M52793542,FT,1299,448390,DEBIT,UPI/452866779338/order/ionbroadband/upi,RFN33776534,2020-04-09
2020-04-12T003:01:31.000Z,M27106360,FT,7999,440391,DEBIT,VIN/titaneyeplus/707984213932/438897734269,RFN56208587,2020-04-12
2020-04-12T022:31:27.000Z,M20091666,FT,3500,436891,DEBIT,IPS/rahulkumar/102471767069/664893498925/BANGALORE,RFN09671333,2020-04-12
2020-04-15T000:23:48.000Z,M43556574,FT,380,436511,DEBIT,UPI/752707953005/order/amul/okhdfcbank,RFN14474625,2020-04-15
2020-04-18T004:40:08.000Z,M17485101,FT,2100,434411,DEBIT,VIN/only/539195082220/764091226274,RFN34918709,2020-04-18
2020-04-18T023:59:59.000Z,M98699478,FT,350,434061,DEBIT,VIN/tatasky/931932262818/070604744675,RFN69078496,2020-04-18
2020-04-22T009:05:51.000Z,M33648544,FT,799,433262,DEBIT,IIN/I-Debit/netflix/618505392563/229019870625,RFN82319172,2020-04-22
2020-04-24T005:09:03.000Z,M14043743,FT,499,432763,DEBIT,VPS/pvr/326024421351/486020154537/BANGALORE,RFN49583494,2020-04-24
2020-04-25T013:15:29.000Z,M30750836,FT,1510,431253,DEBIT,UPI/602279409137/order/landmark/okaxis,RFN95340455,2020-04-25
2020-04-28T003:28:29.000Z,M51611511,FT,789,430464,DEBIT,VPS/irctc/279268156917/166959711817/BLR,RFN33221823,2020-04-28
2020-04-30T012:22:33.000Z,M24065950,FT,25005,405459,DEBIT,MMT/IMPS/862832637140/axispriviledgeccpmt/axis/SIB,RFN46824950,2020-04-30
2020-04-30T015:34:52.000Z,M16225599,FT,15542,389917,DEBIT,MMT/IMPS/410341139691/sbieliteccpmt/axis/KIN,RFN90826178,2020-04-30
2020-05-01T021:00:07.000Z,M76088350,FT,120000,509917,CREDIT,salfintechproductsandsolutions May 2020,RFN63360468,2020-05-01
2020-05-01T018:03:47.000Z,M42455015,FT,3567,506350,DEBIT,ACH/maxlifeinsurance/147413974/6618088316,RFN22436737,2020-05-01
2020-05-01T023:59:37.000Z,M24582539,FT,11345,495005,DEBIT,MMT/IMPS/765514805515/pnbpersonalloan/axis/SBIN,RFN19943899,2020-05-01
2020-05-01T015:55:50.000Z,M78025217,FT,11000,484005,DEBIT,BIL/BPAY/421351475700/motilaloswal/7876915231,RFN97229915,2020-05-01
2020-05-01T002:19:14.000Z,M52044844,FT,10500,473505,DEBIT,BIL/BPAY/551324019765/principalmutualfund/0170935379,RFN52190240,2020-05-01
2020-05-02T007:31:25.000Z,M22970789,FT,160,473345,DEBIT,UPI/544290292295/order/amul/oksbi,RFN94155437,2020-05-02
2020-05-03T005:52:33.000Z,M93388365,FT,3290,470055,DEBIT,IPS/spencers/825098436943/016961234542/BANGALORE,RFN83005909,2020-05-03
2020-05-03T007:18:27.000Z,M89526045,FT,8832,461223,DEBIT,MMT/IMPS/574797237451/idbihomeloan/axis/BLR,RFN40039450,2020-05-03
2020-05-04T023:39:39.000Z,M06707292,FT,12000,449223,DEBIT,MMT/IMPS/920286633945/rent/axis/KIN,RFN51192027,2020-05-04
2020-05-04T005:57:57.000Z,M59144609,FT,496,448727,DEBIT,VIN/eatfit/142630475887/988751411449,RFN73439589,2020-05-04
2020-05-04T019:02:14.000Z,M50732311,FT,6989,441738,DEBIT,VPS/h&m/340220649494/747746284405/BENGALURU,RFN11970481,2020-05-04
2020-05-04T003:47:46.000Z,M91558676,FT,4503,437235,DEBIT,VPS/bangalorecentral/791305297636/274961842977/BLR,RFN87975830,2020-05-04
2020-05-05T009:15:35.000Z,M58604236,FT,402,436833,DEBIT,UPI/564280132875/order/uber/oksbi,RFN54319541,2020-05-05
2020-05-05T002:12:50.000Z,M71838974,FT,8472,428361,DEBIT,VIN/nolimmits/106363988093/975635455174,RFN07612059,2020-05-05
2020-05-05T017:10:47.000Z,M59741106,FT,442,427919,DEBIT,UPI/545908231168/order/uber/okaxis,RFN11291372,2020-05-05
2020-05-05T016:18:25.000Z,M70799089,FT,1280,426639,DEBIT,UPI/783840070850/order/bescom/okaxis,RFN69279265,2020-05-05
2020-05-07T010:32:02.000Z,M15743514,FT,1500,425139,DEBIT,VIN/indianoil/672345485043/273260493604,RFN70474911,2020-05-07
2020-05-08T017:56:49.000Z,M35732464,FT,799,424340,DEBIT,UPI/442650526694/order/bblunt/okicici,RFN47608853,2020-05-08
2020-05-09T011:52:45.000Z,M59759662,FT,1299,423041,DEBIT,UPI/044299009991/order/ionbroadband/okhdfcbank,RFN39976770,2020-05-09
2020-05-10T017:22:39.000Z,M85954578,FT,399,422642,DEBIT,UPI/185916359967/order/jio/oksbi,RFN99924066,2020-05-10
2020-05-11T011:36:13.000Z,M40637104,FT,1540,424182,CREDIT,BIL/ONL/777632490288/48282029013/8044796391,RFN63622556,2020-05-11
2020-05-12T016:17:53.000Z,M38823836,FT,3289,420893,DEBIT,VPS/gilly's/312438749590/507823324868/Begaluru,RFN39329054,2020-05-12
2020-05-15T011:13:02.000Z,M21485539,FT,70,420823,DEBIT,UPI/671245314917/order/amul/okhdfcbank,RFN31056974,2020-05-15
2020-05-18T008:03:06.000Z,M69823913,ATM,3500,417323,DEBIT,ATM/AXZYY541/CASH WDL/2020-05-18,RFN14059941,2020-05-18
2020-05-18T019:34:00.000Z,M20348890,FT,350,416973,DEBIT,VIN/tatasky/503383658891/224922694727,RFN10133230,2020-05-18
2020-05-22T014:06:41.000Z,M09651331,FT,799,416174,DEBIT,IIN/I-Debit/netflix/097430742505/850115277602,RFN47543559,2020-05-22
2020-05-24T005:32:06.000Z,M46638600,FT,299,415875,DEBIT,VPS/pvr/549786413575/541599553815/BLR,RFN52392478,2020-05-24
2020-05-25T002:07:34.000Z,M09620885,ATM,1000,414875,DEBIT,ATM/LIPOE231/CASH WDL/2020-05-25,RFN52871253,2020-05-25
2020-05-28T012:18:35.000Z,M36375268,FT,99,414776,DEBIT,UPI/863288171504/order/kwalitybazaar/upi,RFN63492372,2020-05-28
2020-05-31T014:30:21.000Z,M74726692,FT,25005,389771,DEBIT,MMT/IMPS/039670752177/axispriviledgeccpmt/axis/SBIN,RFN50934623,2020-05-31
2020-05-31T023:22:05.000Z,M26697282,FT,15542,374229,DEBIT,MMT/IMPS/678350758581/sbieliteccpmt/axis/SBIN,RFN47459069,2020-05-31
2020-06-01T015:49:36.000Z,M88548648,FT,120000,494229,CREDIT,salfintechproductsandsolutions June 2020,RFN30909009,2020-06-01
2020-06-01T005:18:31.000Z,M74277868,FT,3567,490662,DEBIT,ACH/maxlifeinsurance/524113213/6728577455,RFN41441572,2020-06-01
2020-06-01T002:20:56.000Z,M26259040,FT,11345,479317,DEBIT,MMT/IMPS/139816302939/pnbpersonalloan/axis/KIN,RFN80499086,2020-06-01
2020-06-01T023:56:13.000Z,M14516488,FT,6000,473317,DEBIT,BIL/BPAY/032188547212/motilaloswal/3002348620,RFN89556412,2020-06-01
2020-06-01T016:05:24.000Z,M55772118,FT,14000,459317,DEBIT,BIL/INF/085250057120/principalmutualfund/9684487975,RFN08756752,2020-06-01
2020-06-02T003:15:20.000Z,M93017553,FT,89000,370317,DEBIT,VIN/iplanet/931595125966/291774743355,RFN62914564,2020-06-02
2020-06-03T021:18:19.000Z,M18479084,FT,1200,369117,DEBIT,IPS/bigbasket/664060367311/424458702253/BANGALORE,RFN95640180,2020-06-03
2020-06-03T013:06:22.000Z,M61213197,FT,8832,360285,DEBIT,MMT/IMPS/793162660625/idbihomeloan/axis/HDF,RFN75630003,2020-06-03
2020-06-04T013:47:29.000Z,M74973690,FT,12000,348285,DEBIT,MMT/IMPS/812958301405/rent/axis/SBIN,RFN10156124,2020-06-04
2020-06-04T010:22:05.000Z,M46743844,FT,249,348036,DEBIT,VIN/kfc/393725349728/161883049829,RFN95951556,2020-06-04
2020-06-05T009:58:12.000Z,M73082145,FT,120,347916,DEBIT,UPI/160019006790/order/uber/okaxis,RFN24253661,2020-06-05
2020-06-05T005:44:25.000Z,M75476131,FT,1480,346436,DEBIT,UPI/949165424363/order/bescom/okicici,RFN56194999,2020-06-05
2020-06-07T013:10:53.000Z,M76237073,FT,2110,344326,DEBIT,UPI/207365571273/order/plated/ybl,RFN27913176,2020-06-07
2020-06-08T001:23:25.000Z,M54949953,ATM,2000,342326,DEBIT,ATM/HJNAQ877/CASH WDL/2020-06-08,RFN06583430,2020-06-08
2020-06-08T001:30:19.000Z,M13383697,FT,3080,339246,DEBIT,VIN/landmark/609502012759/020843600592,RFN37774477,2020-06-08
2020-06-09T023:47:33.000Z,M24287610,FT,1299,337947,DEBIT,UPI/231277405801/order/ionbroadband/oksbi,RFN51898874,2020-06-09
2020-06-12T017:29:30.000Z,M74682467,FT,9999,327948,DEBIT,VPS/adidas/691893562030/534516765331/BENGALURU,RFN78989635,2020-06-12
2020-06-12T003:21:05.000Z,M91591366,FT,230,327718,DEBIT,UPI/322729505943/order/eatfit/okhdfcbank,RFN75554772,2020-06-12
2020-06-15T011:02:34.000Z,M57409373,FT,210,327508,DEBIT,UPI/974325166047/order/amul/oksbi,RFN44673158,2020-06-15
2020-06-18T018:17:43.000Z,M51602404,FT,599,326909,DEBIT,UPI/023707187095/order/croma/okicici,RFN25803411,2020-06-18
2020-06-18T008:46:07.000Z,M32984838,FT,350,326559,DEBIT,VIN/tatasky/339085925802/733473370736,RFN09607829,2020-06-18
2020-06-19T010:25:59.000Z,M38186574,FT,4802,331361,CREDIT,BIL/INF/968272714925/0292192233/0522332325,RFN60725038,2020-06-19
2020-06-19T004:12:18.000Z,M38375772,FT,300,331661,CREDIT,BIL/ONL/053333305866/0324830223/4068196438,RFN11146350,2020-06-19
2020-06-22T019:25:10.000Z,M24448111,FT,799,330862,DEBIT,IIN/I-Debit/netflix/244434103952/928192903356,RFN72446785,2020-06-22
2020-06-28T023:50:47.000Z,M76057504,FT,59,330803,DEBIT,UPI/475272344243/order/kwalitybazaar/ybl,RFN90791987,2020-06-28
2020-06-30T016:27:59.000Z,M66333759,FT,25005,305798,DEBIT,MMT/IMPS/449271701305/axispriviledgeccpmt/axis/SIB,RFN26021147,2020-06-30
2020-06-30T006:09:26.000Z,M55443802,FT,15542,290256,DEBIT,MMT/IMPS/905949426778/sbieliteccpmt/axis/BLR,RFN84850230,2020-06-30
2020-07-01T015:02:53.000Z,M02530684,FT,120000,410256,CREDIT,salfintechproductsandsolutions July 2020,RFN08505650,2020-07-01
2020-07-01T006:16:28.000Z,M29863110,FT,3567,406689,DEBIT,ACH/maxlifeinsurance/869562670/5945184148,RFN43571228,2020-07-01
2020-07-01T007:10:00.000Z,M26018728,FT,11345,395344,DEBIT,MMT/IMPS/931430746504/pnbpersonalloan/axis/SIB,RFN36981133,2020-07-01
2020-07-01T004:04:41.000Z,M76216053,FT,15000,380344,DEBIT,BIL/INF/868070517367/motilaloswal/5287633701,RFN46067451,2020-07-01
2020-07-01T001:07:51.000Z,M91910427,FT,14000,366344,DEBIT,BIL/ONL/852345251591/principalmutualfund/7062615721,RFN38139902,2020-07-01
2020-07-02T008:07:36.000Z,M80828766,FT,230,366114,DEBIT,UPI/162491113993/order/amul/oksbi,RFN46567505,2020-07-02
2020-07-03T011:02:10.000Z,M59014303,FT,1599,364515,DEBIT,IPS/spencers/686071981435/508275617855/BANGALORE,RFN97659938,2020-07-03
2020-07-03T005:22:33.000Z,M33846067,FT,8832,355683,DEBIT,MMT/IMPS/388571263081/idbihomeloan/axis/BLR,RFN73042872,2020-07-03
2020-07-04T015:26:45.000Z,M43953164,FT,12000,343683,DEBIT,MMT/IMPS/712501359939/rent/axis/SIB,RFN82680636,2020-07-04
2020-07-04T020:23:11.000Z,M39675659,FT,242,343441,DEBIT,VIN/burgerking/854170004278/320550805822,RFN18046527,2020-07-04
2020-07-05T017:52:41.000Z,M88968653,FT,540,342901,DEBIT,UPI/616902913179/order/kfc/upi,RFN97904197,2020-07-05
2020-07-05T014:16:20.000Z,M82474713,FT,1542,341359,DEBIT,UPI/262707957167/order/bescom/oksbi,RFN85121906,2020-07-05
2020-07-07T005:31:50.000Z,M98999877,FT,2400,338959,DEBIT,VIN/indianoil/383193072405/243914918482,RFN12809201,2020-07-07
2020-07-08T010:41:40.000Z,M94814351,FT,3598,335361,DEBIT,UPI/409129638752/order/landmark/ybl,RFN97539568,2020-07-08
2020-07-09T004:11:34.000Z,M27927928,FT,1299,334062,DEBIT,UPI/443123429495/order/ionbroadband/okaxis,RFN97255127,2020-07-09
2020-07-12T016:30:31.000Z,M69133753,FT,2889,331173,DEBIT,VPS/veromoda/250748383423/073923394315/BANGALORE,RFN82458046,2020-07-12
2020-07-12T022:13:06.000Z,M82040686,FT,410,330763,DEBIT,UPI/142895892539/order/eatfit/upi,RFN20905083,2020-07-12
2020-07-15T018:45:22.000Z,M22136905,FT,790,329973,DEBIT,UPI/012407505852/order/beijingbites/okicici,RFN44740518,2020-07-15
2020-07-16T018:47:15.000Z,M05869912,FT,3123,333096,CREDIT,BIL/ONL/689493098595/323455920392/4495897453,RFN33903456,2020-07-16
2020-07-18T022:30:36.000Z,M45480634,FT,3999,329097,DEBIT,UPI/514007899349/order/bangalorecentral/okhdfcbank,RFN51255094,2020-07-18
2020-07-18T009:06:02.000Z,M06599929,FT,350,328747,DEBIT,VIN/tatasky/696644776123/400779880609,RFN62370146,2020-07-18
2020-07-22T013:29:21.000Z,M38809423,FT,799,327948,DEBIT,IIN/I-Debit/netflix/497109068755/375811938952,RFN88241157,2020-07-22
2020-07-24T012:12:11.000Z,M90928606,FT,450,327498,DEBIT,VPS/pvr/667558493868/470801895489/BANGALORE,RFN77664783,2020-07-24
2020-07-25T006:37:53.000Z,M66115977,FT,50,327448,DEBIT,UPI/866381255819/order/amul/upi,RFN77983612,2020-07-25
2020-07-28T001:48:17.000Z,M23531987,FT,120,327328,DEBIT,UPI/410004173399/order/kwalitybazaar/upi,RFN55598657,2020-07-28
2020-07-31T005:46:44.000Z,M23227063,FT,25005,302323,DEBIT,MMT/IMPS/980978435520/axispriviledgeccpmt/axis/SIB,RFN70391297,2020-07-31
2020-07-31T007:21:33.000Z,M14190098,FT,15542,286781,DEBIT,MMT/IMPS/097363897618/sbieliteccpmt/axis/BLR,RFN55122183,2020-07-31
2020-07-31T007:22:31.000Z,M56456828,ATM,5000,281781,DEBIT,ATM/NOUOM115/CASH WDL/2020-07-31,RFN51323409,2020-07-31
