transactionTimestamp,txnId,mode,amount,balance,type,narration,reference,valueDate
2019-08-01T002:01:12.000Z,M97799494,FT,120000,539769,CREDIT,salfintechproductsandsolutions August 2019,RFN28183261,2019-08-01
2019-08-01T000:52:26.000Z,M58685198,FT,3567,536202,DEBIT,ACH/maxlifeinsurance/021556480/7932628520,RFN34741052,2019-08-01
2019-08-01T018:18:24.000Z,M46417310,FT,12000,524202,DEBIT,BIL/BPAY/257110357936/motilaloswal/8014080594,RFN54541494,2019-08-01
2019-08-01T008:21:48.000Z,M36699284,FT,10000,514202,DEBIT,BIL/INF/199090801944/principalmutualfund/5517187556,RFN83984199,2019-08-01
2019-08-01T022:24:39.000Z,M33310776,FT,11345,502857,DEBIT,MMT/IMPS/974115535692/pnbpersonalloan/axis/BLR,RFN24322912,2019-08-01
2019-08-02T014:43:17.000Z,M50287816,FT,50,502807,DEBIT,UPI/759629565998/order/amul/okhdfcbank,RFN34107526,2019-08-02
2019-08-03T012:55:58.000Z,M35388557,FT,2231,500576,DEBIT,IPS/spencers/478915026070/515493051534/BANGALORE,RFN57411848,2019-08-03
2019-08-03T001:10:24.000Z,M89418301,FT,8832,491744,DEBIT,MMT/IMPS/936148081269/pnbpersonalloan/axis/KIN,RFN71271496,2019-08-03
2019-08-04T017:57:08.000Z,M49845535,FT,12000,479744,DEBIT,MMT/IMPS/040377401095/rent/axis/HDF,RFN47759624,2019-08-04
2019-08-04T022:45:41.000Z,M89701782,FT,242,479502,DEBIT,VIN/burgerking/086403095070/519321985151,RFN10970721,2019-08-04
2019-08-05T019:28:37.000Z,M38127214,FT,330,479172,DEBIT,UPI/329198467748/order/uber/okaxis,RFN18997407,2019-08-05
2019-08-05T009:58:01.000Z,M14653604,FT,1380,477792,DEBIT,UPI/470795235956/order/bescom/oksbi,RFN30853877,2019-08-05
2019-08-07T014:00:24.000Z,M57060973,FT,1500,476292,DEBIT,VIN/indianoil/162819588109/357476770787,RFN03186952,2019-08-07
2019-08-08T023:48:35.000Z,M55186791,FT,200,476092,DEBIT,UPI/564711730555/order/kwalitybazaar/okhdfcbank,RFN11946404,2019-08-08
2019-08-09T006:00:32.000Z,M08572381,FT,1299,474793,DEBIT,UPI/863404999886/order/ionbroadband/upi,RFN46159606,2019-08-09
2019-08-10T014:52:53.000Z,M33268904,FT,399,474394,DEBIT,UPI/652042286241/order/jio/ybl,RFN42527030,2019-08-10
2019-08-12T008:56:20.000Z,M57661864,FT,3289,471105,DEBIT,VPS/veromoda/902675654597/313744059789/bangalore,RFN08494229,2019-08-12
2019-08-12T014:40:24.000Z,M58532705,FT,1110,469995,DEBIT,IPS/beijingbites/600982096948/612453207493/BANGALORE,RFN39355730,2019-08-12
2019-08-15T011:17:32.000Z,M09109236,FT,180,469815,DEBIT,UPI/814323406385/order/amul/ybl,RFN73659089,2019-08-15
2019-08-18T007:24:13.000Z,M35708605,FT,419,469396,DEBIT,UPI/602822104716/order/1mg/ybl,RFN63377220,2019-08-18
2019-08-18T002:57:28.000Z,M97604897,FT,350,469046,DEBIT,VIN/tatasky/045448052820/283711897741,RFN97652609,2019-08-18
2019-08-22T003:32:22.000Z,M12959013,FT,799,468247,DEBIT,IIN/I-Debit/netflix/780925617212/057345524323,RFN94639579,2019-08-22
2019-08-24T006:19:03.000Z,M10656904,FT,299,467948,DEBIT,VPS/pvr/004938992465/240098288520/BANGALORE,RFN37036204,2019-08-24
2019-08-25T015:48:02.000Z,M54280695,FT,150,467798,DEBIT,UPI/143208739615/order/amul/okicici,RFN27506873,2019-08-25
2019-08-28T004:14:49.000Z,M47746560,FT,99,467699,DEBIT,UPI/169409872820/order/kwalitybazaar/ybl,RFN71013970,2019-08-28
2019-08-31T007:52:47.000Z,M79322021,FT,25005,442694,DEBIT,MMT/IMPS/881780347866/axispriviledgeccpmt/axis/SIB,RFN74583161,2019-08-31
2019-08-31T014:37:24.000Z,M58194143,FT,15542,427152,DEBIT,MMT/IMPS/061295707545/sbieliteccpmt/axis/KIN,RFN10461233,2019-08-31
2019-09-01T012:18:40.000Z,M48559518,FT,120000,547152,CREDIT,salfintechproductsandsolutions September 2019,RFN56168906,2019-09-01
2019-09-01T011:57:26.000Z,M14925555,FT,3567,543585,DEBIT,ACH/maxlifeinsurance/917083874/8548009150,RFN35261174,2019-09-01
2019-09-01T004:16:29.000Z,M35882100,FT,11345,532240,DEBIT,MMT/IMPS/197575082230/pnbpersonalloan/axis/SBIN,RFN29032378,2019-09-01
2019-09-01T009:46:25.000Z,M73164893,FT,15000,517240,DEBIT,BIL/ONL/508116047468/motilaloswal/0096141735,RFN81562685,2019-09-01
2019-09-01T012:26:22.000Z,M78795185,FT,10000,507240,DEBIT,BIL/BPAY/548232221617/principalmutualfund/5375183792,RFN22029401,2019-09-01
2019-09-03T011:02:41.000Z,M79034329,FT,80,507160,DEBIT,UPI/263609549459/order/skrolls/okicici,RFN22788155,2019-09-03
2019-09-03T015:05:27.000Z,M81257320,FT,100,507060,DEBIT,UPI/393376057002/order/amul/upi,RFN61950108,2019-09-03
2019-09-03T013:57:37.000Z,M38349686,FT,1588,505472,DEBIT,IPS/spencers/121451013356/001039811718/BANGALORE,RFN83922010,2019-09-03
2019-09-03T011:35:09.000Z,M23298030,FT,8832,496640,DEBIT,MMT/IMPS/076026471928/pnbpersonalloan/axis/SIB,RFN18587636,2019-09-03
2019-09-04T008:04:15.000Z,M47189359,FT,12000,484640,DEBIT,MMT/IMPS/529642586610/rent/axis/SIB,RFN79909843,2019-09-04
2019-09-05T011:57:09.000Z,M83575023,FT,898,483742,DEBIT,VIN/beijingbites/807383297023/231123696594,RFN66910422,2019-09-05
2019-09-05T001:44:46.000Z,M68881564,FT,30500,514242,CREDIT,BIL/INF/245550641198/994302139330/3370079515,RFN28677617,2019-09-05
2019-09-05T017:00:44.000Z,M07072403,FT,1680,512562,DEBIT,UPI/169499709781/order/bescom/okaxis,RFN38604026,2019-09-05
2019-09-06T018:18:46.000Z,M84415759,FT,459,512103,DEBIT,VPS/pvr/110214077712/840366739527/bangalore,RFN19392800,2019-09-06
2019-09-08T010:26:19.000Z,M82173038,FT,100,512003,DEBIT,UPI/048918158280/order/kwalitybazaar/ybl,RFN58545146,2019-09-08
2019-09-08T020:50:20.000Z,M47960529,FT,80,511923,DEBIT,UPI/328485112967/order/amul/upi,RFN54225965,2019-09-08
2019-09-09T017:10:18.000Z,M39383761,FT,1299,510624,DEBIT,UPI/792221301474/order/ionbroadband/okicici,RFN43196886,2019-09-09
2019-09-12T008:29:07.000Z,M18547169,FT,420,510204,DEBIT,VPS/eatfit/543080937425/300371404850/BENGALURU,RFN56146302,2019-09-12
2019-09-12T013:11:08.000Z,M61505526,FT,14394,495810,DEBIT,IPS/cleartrip/437471877296/639200436801/BANGALORE,RFN72752743,2019-09-12
2019-09-15T007:46:18.000Z,M39550258,FT,150,495660,DEBIT,UPI/923298255475/order/bblunt/okicici,RFN97145115,2019-09-15
2019-09-17T005:40:43.000Z,M67559541,FT,1400,494260,DEBIT,VIN/bluo/830799561773/065867565864,RFN83535519,2019-09-17
2019-09-18T009:00:22.000Z,M35812184,FT,419,493841,DEBIT,UPI/133979597245/order/chaipoint/okicici,RFN64423043,2019-09-18
2019-09-18T020:41:29.000Z,M76185693,FT,350,493491,DEBIT,VIN/tatasky/439920585146/747054647227,RFN71194353,2019-09-18
2019-09-22T011:42:07.000Z,M69646316,FT,799,492692,DEBIT,IIN/I-Debit/netflix/155010502464/182589157601,RFN89230297,2019-09-22
2019-09-24T012:50:42.000Z,M25964652,FT,399,492293,DEBIT,VPS/pvr/172341659291/332677984029/BENGALURU,RFN31132904,2019-09-24
2019-09-24T011:45:28.000Z,M32814279,FT,129,492164,DEBIT,UPI/073002322305/order/uber/oksbi,RFN81980129,2019-09-24
2019-09-28T004:30:04.000Z,M47518468,FT,702,491462,DEBIT,UPI/839765962039/order/kwalitybazaar/okaxis,RFN16847864,2019-09-28
2019-09-30T007:04:31.000Z,M85529853,FT,25005,466457,DEBIT,MMT/IMPS/831661969822/axispriviledgeccpmt/axis/HDF,RFN08416376,2019-09-30
2019-09-30T005:57:51.000Z,M82353860,FT,205,466252,DEBIT,UPI/358668210675/order/amazon/oksbi,RFN90738225,2019-09-30
2019-09-30T000:24:21.000Z,M61870543,FT,15542,450710,DEBIT,MMT/IMPS/135652111341/sbieliteccpmt/axis/HDF,RFN65485683,2019-09-30
2019-09-30T017:40:43.000Z,M04912704,ATM,10000,440710,DEBIT,ATM/JSYQY728/CASH WDL/2019-09-30,RFN01564103,2019-09-30
2019-10-01T021:02:53.000Z,M82300633,FT,120000,560710,CREDIT,salfintechproductsandsolutions October 2019,RFN61879050,2019-10-01
2019-10-01T023:29:48.000Z,M68114196,FT,3567,557143,DEBIT,ACH/maxlifeinsurance/123188359/3158092436,RFN88456619,2019-10-01
2019-10-01T000:05:19.000Z,M81272558,FT,11345,545798,DEBIT,MMT/IMPS/983445489759/pnbpersonalloan/axis/SBIN,RFN70688346,2019-10-01
2019-10-01T020:06:32.000Z,M73759425,FT,9000,536798,DEBIT,BIL/BPAY/149877631709/motilaloswal/1496058574,RFN89780860,2019-10-01
2019-10-01T013:54:45.000Z,M54735591,FT,15000,521798,DEBIT,BIL/BPAY/858667834517/principalmutualfund/7797958876,RFN90849398,2019-10-01
2019-10-02T019:02:35.000Z,M99335452,FT,560,521238,DEBIT,UPI/675608155303/order/kfc/ybl,RFN83983730,2019-10-02
2019-10-03T011:53:46.000Z,M05504136,FT,560,520678,DEBIT,IPS/pvr/228556009926/572329265325/BANGALORE,RFN87463396,2019-10-03
2019-10-03T015:41:17.000Z,M29500549,FT,8832,511846,DEBIT,MMT/IMPS/314218304266/pnbpersonalloan/axis/SIB,RFN46182491,2019-10-03
2019-10-04T000:24:23.000Z,M20186177,FT,12000,499846,DEBIT,MMT/IMPS/387693616107/rent/axis/KIN,RFN00236857,2019-10-04
2019-10-04T014:18:38.000Z,M79035252,FT,3500,496346,DEBIT,VIN/veromoda/811933719653/666169633710,RFN62157059,2019-10-04
2019-10-04T018:43:23.000Z,M11915573,FT,7500,488846,DEBIT,VIN/adidas/895372510253/565489371523,RFN60875657,2019-10-04
2019-10-04T020:20:38.000Z,M13340890,FT,280,488566,DEBIT,UPI/738687274393/order/uber/upi,RFN34312034,2019-10-04
2019-10-05T003:56:10.000Z,M20755590,FT,1140,487426,DEBIT,UPI/115959777165/order/bescom/okhdfcbank,RFN67232935,2019-10-05
2019-10-07T004:01:15.000Z,M17262524,FT,2000,485426,DEBIT,VIN/indianoil/269008738620/239033051050,RFN72340357,2019-10-07
2019-10-08T002:02:34.000Z,M34888606,FT,1200,484226,DEBIT,UPI/787539446375/order/kwalitybazaar/oksbi,RFN03204813,2019-10-08
2019-10-10T012:06:02.000Z,M59325542,FT,1299,482927,DEBIT,UPI/251323765067/order/ionbroadband/ybl,RFN78882237,2019-10-10
2019-10-12T003:01:37.000Z,M50971841,FT,130,482797,DEBIT,UPI/560890830700/order/amul/okicici,RFN63235370,2019-10-12
2019-10-12T014:43:14.000Z,M76506886,FT,1510,481287,DEBIT,IPS/beijingbites/654521857970/431981554167/BANGALORE,RFN96332521,2019-10-12
2019-10-12T019:47:51.000Z,M63583155,FT,1240,480047,DEBIT,UPI/089510890951/order/sugar/upi,RFN18679258,2019-10-12
2019-10-13T008:52:18.000Z,M97305926,FT,6599,473448,DEBIT,VIN/nolimmits/514434531381/240169182614,RFN87553733,2019-10-13
2019-10-13T004:52:20.000Z,M10674481,FT,830,472618,DEBIT,UPI/260664654334/order/uber/oksbi,RFN68792040,2019-10-13
2019-10-14T021:00:24.000Z,M68052062,FT,180,472438,DEBIT,UPI/689681387871/order/amul/okaxis,RFN41804917,2019-10-14
2019-10-14T000:01:48.000Z,M31418054,FT,100,472338,DEBIT,UPI/797323893562/order/amul/okaxis,RFN30839915,2019-10-14
2019-10-18T016:12:24.000Z,M43527311,FT,350,471988,DEBIT,VIN/tatasky/198120024619/024832209194,RFN60352861,2019-10-18
2019-10-22T018:54:29.000Z,M18736627,FT,799,471189,DEBIT,IIN/I-Debit/netflix/485698008203/097890951355,RFN92806150,2019-10-22
2019-10-24T001:27:50.000Z,M00836901,FT,299,470890,DEBIT,VPS/pvr/672780549327/217342413675/BENGALURU,RFN44274268,2019-10-24
2019-10-25T018:18:05.000Z,M94929840,FT,270,470620,DEBIT,UPI/897751199930/order/swiggy/okhdfcbank,RFN58076352,2019-10-25
2019-10-26T008:33:02.000Z,M39604689,FT,2700,467920,DEBIT,VIN/indianoil/594408189524/492197632925,RFN96698829,2019-10-26
2019-10-26T010:07:40.000Z,M12738916,FT,40000,507920,CREDIT,BIL/INF/426691263427/233488841023/1114016673,RFN06787082,2019-10-26
2019-10-28T014:48:16.000Z,M92930772,FT,2001,505919,DEBIT,UPI/917621038202/order/decathlon/oksbi,RFN29105002,2019-10-28
2019-10-28T020:57:01.000Z,M82237522,FT,1900,504019,DEBIT,IPS/dentistclinic/228987396986/618879388499/BANGALORE,RFN63407460,2019-10-28
2019-10-31T010:21:41.000Z,M22525783,FT,25005,479014,DEBIT,MMT/IMPS/393391648253/axispriviledgeccpmt/axis/BLR,RFN80327242,2019-10-31
2019-10-31T015:09:21.000Z,M81834722,FT,15542,463472,DEBIT,MMT/IMPS/497525637753/sbieliteccpmt/axis/SBIN,RFN11051945,2019-10-31
2019-11-01T023:04:31.000Z,M86826023,FT,120000,583472,CREDIT,salfintechproductsandsolutions November 2019,RFN13446492,2019-11-01
2019-11-01T016:52:18.000Z,M76448902,FT,3567,579905,DEBIT,ACH/maxlifeinsurance/574552093/5408139126,RFN46873023,2019-11-01
2019-11-01T016:20:45.000Z,M11468376,FT,11345,568560,DEBIT,MMT/IMPS/268574720708/pnbpersonalloan/axis/BLR,RFN08474655,2019-11-01
2019-11-01T023:19:38.000Z,M93030873,FT,8000,560560,DEBIT,BIL/INF/748784485932/motilaloswal/4274193457,RFN92253748,2019-11-01
2019-11-01T015:09:32.000Z,M36204199,FT,8000,552560,DEBIT,BIL/INF/741817802689/principalmutualfund/5934292742,RFN67212501,2019-11-01
2019-11-02T007:53:01.000Z,M23374686,FT,70,552490,DEBIT,UPI/917062632253/order/amul/okhdfcbank,RFN85179259,2019-11-02
2019-11-03T015:43:13.000Z,M04864459,FT,2730,549760,DEBIT,IPS/spencers/598482846687/888521859507/BANGALORE,RFN58882845,2019-11-03
2019-11-03T011:02:48.000Z,M24391481,FT,8832,540928,DEBIT,MMT/IMPS/403010579397/pnbpersonalloan/axis/KIN,RFN54978253,2019-11-03
2019-11-04T009:43:52.000Z,M43255306,FT,12000,528928,DEBIT,MMT/IMPS/191361331610/rent/axis/HDF,RFN23511393,2019-11-04
2019-11-04T006:40:16.000Z,M51364224,FT,890,528038,DEBIT,VIN/kfc/802074371731/307296735978,RFN53134174,2019-11-04
2019-11-04T012:19:59.000Z,M64989652,FT,799,527239,DEBIT,VIN/bblunt/460859872388/406267833212,RFN97067700,2019-11-04
2019-11-05T019:18:36.000Z,M26017848,FT,2999,524240,DEBIT,UPI/341162748501/order/indianoil/okhdfcbank,RFN38737905,2019-11-05
2019-11-05T017:42:48.000Z,M54036279,FT,1654,522586,DEBIT,UPI/097722170635/order/bescom/okhdfcbank,RFN32973812,2019-11-05
2019-11-07T012:13:35.000Z,M22912440,FT,1500,521086,DEBIT,VIN/indianoil/841547218871/100268921132,RFN60586006,2019-11-07
2019-11-08T005:15:28.000Z,M54083792,FT,240,520846,DEBIT,UPI/308761606993/order/kwalitybazaar/okicici,RFN84346910,2019-11-08
2019-11-11T011:17:57.000Z,M05877777,FT,1299,519547,DEBIT,UPI/177783669231/order/ionbroadband/ybl,RFN39460744,2019-11-11
2019-11-10T020:29:26.000Z,M32263979,FT,399,519148,DEBIT,UPI/868126134399/order/jio/upi,RFN28493112,2019-11-10
2019-11-12T015:29:22.000Z,M95917065,FT,333,518815,DEBIT,UPI/008088871768/order/uber/okaxis,RFN35636338,2019-11-12
2019-11-12T001:39:55.000Z,M57880244,FT,2508,516307,DEBIT,IPS/gilly's/229635672525/345411972369/BANGALORE,RFN06746405,2019-11-12
2019-11-12T022:28:04.000Z,M53932985,FT,339,515968,DEBIT,UPI/290344153449/order/uber/upi,RFN31271780,2019-11-12
2019-11-15T001:43:05.000Z,M13994239,FT,130,515838,DEBIT,UPI/112942166872/order/1mg/okaxis,RFN47943243,2019-11-15
2019-11-15T008:40:23.000Z,M23488419,FT,10000,525838,CREDIT,BIL/ONL/030765451775/94320092/8012429220,RFN10161734,2019-11-15
2019-11-18T008:54:12.000Z,M47643234,FT,2019,523819,DEBIT,UPI/909399312914/order/oriflame/okaxis,RFN70283260,2019-11-18
2019-11-18T013:02:51.000Z,M26584608,FT,350,523469,DEBIT,VIN/tatasky/885500651443/734152367453,RFN28596777,2019-11-18
2019-11-22T019:23:52.000Z,M55210402,FT,799,522670,DEBIT,IIN/I-Debit/netflix/905856716130/827471471102,RFN21298570,2019-11-22
2019-11-24T022:44:11.000Z,M49439784,FT,540,522130,DEBIT,VPS/pvr/203632261307/917312794003/BANGALOR,RFN34974675,2019-11-24
2019-11-25T023:48:27.000Z,M64311129,FT,150,521980,DEBIT,UPI/713689409173/order/amul/okaxis,RFN47101385,2019-11-25
2019-11-26T018:42:15.000Z,M17489558,FT,3500,518480,DEBIT,VIN/tonique/802348861469/750162079419,RFN75675882,2019-11-26
2019-11-26T003:40:15.000Z,M42250422,FT,2034,516446,DEBIT,VIN/spencer/587859865817/268198066937,RFN33157615,2019-11-26
2019-11-28T003:18:22.000Z,M55614463,FT,1900,514546,DEBIT,UPI/577097663281/order/dentistclinic/oksbi,RFN63412267,2019-11-28
2019-11-30T003:23:12.000Z,M77899813,FT,25005,489541,DEBIT,MMT/IMPS/884080280477/axispriviledgeccpmt/axis/SBIN,RFN02766215,2019-11-30
2019-11-30T007:48:11.000Z,M37306728,FT,15542,473999,DEBIT,MMT/IMPS/807683497890/sbieliteccpmt/axis/HDF,RFN82750802,2019-11-30
2019-12-01T004:15:58.000Z,M69417603,FT,120000,593999,CREDIT,salfintechproductsandsolutions December 2019,RFN98657550,2019-12-01
2019-12-01T008:52:41.000Z,M41172864,FT,3567,590432,DEBIT,ACH/maxlifeinsurance/152390427/9632439702,RFN54711799,2019-12-01
2019-12-01T011:08:54.000Z,M99968408,FT,11345,579087,DEBIT,MMT/IMPS/692799608097/pnbpersonalloan/axis/BLR,RFN67601856,2019-12-01
2019-12-01T019:48:15.000Z,M67069253,FT,12000,567087,DEBIT,BIL/INF/598860158533/motilaloswal/2573802116,RFN46508504,2019-12-01
2019-12-01T014:40:01.000Z,M72154290,FT,12000,555087,DEBIT,BIL/BPAY/924082719062/principalmutualfund/1548580407,RFN35012221,2019-12-01
2019-12-02T017:48:44.000Z,M45300844,FT,80,555007,DEBIT,UPI/416682577608/order/amul/okhdfcbank,RFN24040726,2019-12-02
2019-12-03T015:50:50.000Z,M09355001,FT,1409,553598,DEBIT,IPS/spencers/997212005594/168931455848/BANGALORE,RFN20218268,2019-12-03
2019-12-03T007:59:55.000Z,M25530191,FT,8832,544766,DEBIT,MMT/IMPS/507872255467/pnbpersonalloan/axis/KIN,RFN04319837,2019-12-03
2019-12-04T019:17:15.000Z,M11340519,FT,12000,532766,DEBIT,MMT/IMPS/594816427890/rent/axis/SBIN,RFN13022789,2019-12-04
2019-12-04T001:59:01.000Z,M29397254,FT,242,532524,DEBIT,VIN/burgerking/832894047251/213963104950,RFN02784179,2019-12-04
2019-12-04T010:58:33.000Z,M26707736,FT,597,531927,DEBIT,UPI/218261181555/order/cafecofffeeday/oksbi,RFN71332704,2019-12-04
2019-12-05T020:31:30.000Z,M53659197,FT,540,531387,DEBIT,UPI/001881012542/order/kwalitybazaar/okaxis,RFN22255186,2019-12-05
2019-12-05T012:40:02.000Z,M67009357,FT,1220,530167,DEBIT,UPI/724142454218/order/bescom/okhdfcbank,RFN13528536,2019-12-05
2019-12-07T015:26:11.000Z,M21560645,FT,1430,528737,DEBIT,VIN/indianoil/836734600667/729039517540,RFN14151992,2019-12-07
2019-12-08T011:31:15.000Z,M38709783,FT,200,528537,DEBIT,UPI/129206479332/order/kwalitybazaar/ybl,RFN36631188,2019-12-08
2019-12-15T010:52:39.000Z,M00012765,FT,40000,568537,CREDIT,BIL/INF/201921702463/8884492110/8558269589,RFN32692793,2019-12-15
2019-12-09T003:41:21.000Z,M60895599,FT,1299,567238,DEBIT,UPI/772781177948/order/ionbroadband/ybl,RFN76839738,2019-12-09
2019-12-10T013:18:42.000Z,M67900105,ATM,2500,564738,DEBIT,ATM/LKJPZ971/CASH WDL/2019-12-10,RFN96618844,2019-12-10
2019-12-11T002:21:06.000Z,M17899275,FT,430,564308,DEBIT,VPS/pvr/544388536096/581138375033/Begaluru,RFN93461344,2019-12-11
2019-12-12T005:18:50.000Z,M90566005,FT,743,563565,DEBIT,IIN/I-Debit/smokehouse/493371511099/576531123311,RFN99247669,2019-12-12
2019-12-12T013:41:05.000Z,M49831005,FT,500,563065,DEBIT,IPS/vedantsaxena/369553499614/495840805034/BANGALORE,RFN73156503,2019-12-12
2019-12-15T003:04:29.000Z,M16895428,FT,280,562785,DEBIT,UPI/179997338808/order/amul/okicici,RFN17152613,2019-12-15
2019-12-18T021:13:00.000Z,M62098060,FT,399,562386,DEBIT,UPI/016160310871/order/hairspeak/upi,RFN73055546,2019-12-18
2019-12-18T015:13:25.000Z,M55880003,FT,350,562036,DEBIT,VIN/tatasky/319332403236/047313415525,RFN44230383,2019-12-18
2019-12-22T013:27:22.000Z,M63588378,FT,799,561237,DEBIT,IIN/I-Debit/netflix/927225411389/691221972172,RFN03344113,2019-12-22
2019-12-24T021:14:12.000Z,M95570616,FT,299,560938,DEBIT,VPS/pvr/683854340852/595851608252/BANGALOR,RFN70054220,2019-12-24
2019-12-25T021:39:58.000Z,M13157400,FT,340,560598,DEBIT,UPI/675126227478/order/zomato/ybl,RFN76025375,2019-12-25
2019-12-28T003:51:27.000Z,M72676940,FT,4999,555599,DEBIT,VPS/h&m/846969418070/793858094257/BANGALORE,RFN08860796,2019-12-28
2019-12-28T021:02:06.000Z,M08543376,FT,1900,553699,DEBIT,UPI/696114669560/order/dentistclinic/oksbi,RFN36716776,2019-12-28
2019-12-31T019:14:47.000Z,M16259187,FT,25005,528694,DEBIT,MMT/IMPS/337331765926/axispriviledgeccpmt/axis/HDF,RFN69948282,2019-12-31
2019-12-31T009:25:30.000Z,M03400314,FT,15542,513152,DEBIT,MMT/IMPS/003216122269/sbieliteccpmt/axis/SBIN,RFN33445921,2019-12-31
2020-01-01T009:13:15.000Z,M65580927,FT,120000,633152,CREDIT,salfintechproductsandsolutions January 2020,RFN79386393,2020-01-01
2020-01-01T008:34:15.000Z,M44583941,FT,3567,629585,DEBIT,ACH/maxlifeinsurance/115509642/5926041256,RFN43799865,2020-01-01
2020-01-01T002:40:15.000Z,M58850928,FT,11345,618240,DEBIT,MMT/IMPS/246644682510/pnbpersonalloan/axis/KIN,RFN75899596,2020-01-01
2020-01-01T007:56:55.000Z,M66743173,FT,15000,603240,DEBIT,BIL/BPAY/258692066037/motilaloswal/4584888047,RFN51060747,2020-01-01
2020-01-02T017:51:31.000Z,M29362414,FT,1209,602031,DEBIT,UPI/584848366793/order/kfc/upi,RFN99633551,2020-01-02
2020-01-03T006:39:07.000Z,M91716601,FT,1939,600092,DEBIT,IPS/spencers/266356381977/510713906424/BANGALORE,RFN21351425,2020-01-03
2020-01-03T003:47:52.000Z,M47117139,FT,8832,591260,DEBIT,MMT/IMPS/687833330646/pnbpersonalloan/axis/KIN,RFN50640738,2020-01-03
2020-01-04T020:50:23.000Z,M93835819,FT,60000,651260,CREDIT,BIL/INF/302915696508/88844432292110/1096474108,RFN57522722,2020-01-04
2020-01-04T013:09:49.000Z,M44889404,FT,12000,639260,DEBIT,MMT/IMPS/669573028417/rent/axis/HDF,RFN03948450,2020-01-04
2020-01-04T004:21:36.000Z,M79588368,FT,3999,635261,DEBIT,VIN/h&m/228773796535/709639579700,RFN81458926,2020-01-04
2020-01-04T000:08:06.000Z,M03144651,FT,1999,633262,DEBIT,VIN/catwalk/258158982157/398281969383,RFN10396759,2020-01-04
2020-01-05T009:55:06.000Z,M97629608,FT,880,632382,DEBIT,UPI/226929422294/order/uber/upi,RFN70267098,2020-01-05
2020-01-05T019:24:42.000Z,M61251083,FT,8902,623480,DEBIT,UPI/411288382932/order/gilly's/oksbi,RFN20258769,2020-01-05
2020-01-05T008:10:03.000Z,M08649502,FT,640,622840,DEBIT,UPI/574732705377/order/uber/okhdfcbank,RFN51662981,2020-01-05
2020-01-05T011:44:49.000Z,M03707735,FT,1380,621460,DEBIT,UPI/064427762472/order/bescom/oksbi,RFN02983777,2020-01-05
2020-01-07T000:37:04.000Z,M21398303,FT,20208,601252,DEBIT,VIN/cleartrip/334908691108/770828619429,RFN52624718,2020-01-07
2020-01-08T001:24:42.000Z,M41357170,FT,4999,596253,DEBIT,VIN/americantourister/992738636555/946935302020,RFN78041727,2020-01-08
2020-01-09T015:20:58.000Z,M86614148,FT,1299,594954,DEBIT,UPI/702951872864/order/ionbroadband/okaxis,RFN75079783,2020-01-09
2020-01-12T003:35:39.000Z,M80589435,FT,3994,590960,DEBIT,VPS/veromoda/678618935739/411086020452/BLR,RFN40396447,2020-01-12
2020-01-12T010:30:45.000Z,M02115022,FT,1410,589550,DEBIT,UPI/623888490204/order/kfc/okicici,RFN69009797,2020-01-12
2020-01-15T001:10:55.000Z,M89835078,FT,480,589070,DEBIT,UPI/784516321568/order/stonedmonkey/ybl,RFN77450176,2020-01-15
2020-01-18T016:18:01.000Z,M29770534,FT,750,588320,DEBIT,UPI/020634541986/order/zomato/oksbi,RFN96174472,2020-01-18
2020-01-18T015:18:55.000Z,M63041266,FT,350,587970,DEBIT,VIN/tatasky/849171062047/021126471535,RFN49293394,2020-01-18
2020-01-22T015:24:54.000Z,M96114628,FT,799,587171,DEBIT,IIN/I-Debit/netflix/481877030337/403140582077,RFN05396951,2020-01-22
2020-01-23T016:22:11.000Z,M05500821,FT,189,586982,DEBIT,VPS/pvr/892148799173/213403875456/BLR,RFN04953563,2020-01-23
2020-01-24T009:12:01.000Z,M32575539,FT,20000,606982,CREDIT,BIL/ONL/183180027504/00333954322234955/6130488092,RFN74981705,2020-01-24
2020-01-25T016:29:25.000Z,M36050427,FT,1440,605542,DEBIT,UPI/241515125758/order/amazon/okicici,RFN66061496,2020-01-25
2020-01-28T020:41:56.000Z,M60876170,FT,1900,603642,DEBIT,UPI/416336641839/order/dentistclinic/okicici,RFN02824886,2020-01-28
2020-01-28T001:43:44.000Z,M61628735,FT,399,603243,DEBIT,UPI/511797173184/order/kwalitybazaar/ybl,RFN69197994,2020-01-28
2020-01-31T022:29:19.000Z,M22977795,FT,25005,578238,DEBIT,MMT/IMPS/869865728627/axispriviledgeccpmt/axis/KIN,RFN27373161,2020-01-31
2020-01-31T002:14:54.000Z,M81345385,FT,15542,562696,DEBIT,MMT/IMPS/987221109724/sbieliteccpmt/axis/BLR,RFN63068268,2020-01-31
2020-02-01T002:59:07.000Z,M01801509,FT,120000,682696,CREDIT,salfintechproductsandsolutions February 2020,RFN69074705,2020-02-01
2020-02-01T014:08:28.000Z,M92373110,FT,3567,679129,DEBIT,ACH/maxlifeinsurance/629322576/3150690257,RFN93246783,2020-02-01
2020-02-01T005:26:49.000Z,M94118610,FT,11345,667784,DEBIT,MMT/IMPS/853308931906/pnbpersonalloan/axis/BLR,RFN36985024,2020-02-01
2020-02-01T010:44:17.000Z,M03881703,FT,5000,662784,DEBIT,BIL/INF/219071950141/motilaloswal/7013514315,RFN37692657,2020-02-01
2020-02-01T018:45:02.000Z,M80835864,FT,5000,657784,DEBIT,BIL/ONL/180475237735/principalmutualfund/7458576429,RFN71602724,2020-02-01
2020-02-02T014:14:41.000Z,M80955477,FT,670,657114,DEBIT,UPI/246954249907/order/cafecofeeday/okaxis,RFN04849669,2020-02-02
2020-02-03T009:15:32.000Z,M78596796,FT,3100,654014,DEBIT,IPS/spencers/518558612918/546299735891/BANGALORE,RFN44603963,2020-02-03
2020-02-03T020:52:22.000Z,M01678365,FT,8832,645182,DEBIT,MMT/IMPS/121161007029/pnbpersonalloan/axis/BLR,RFN20717032,2020-02-03
2020-02-04T013:53:21.000Z,M99269703,FT,12000,633182,DEBIT,MMT/IMPS/048786153447/rent/axis/SIB,RFN01448585,2020-02-04
2020-02-04T015:55:37.000Z,M23671934,FT,550,632632,DEBIT,VIN/kfc/526008233150/930854556511,RFN28301201,2020-02-04
2020-02-05T004:35:01.000Z,M13203128,FT,1380,631252,DEBIT,UPI/501131348263/order/bescom/okhdfcbank,RFN03002721,2020-02-05
2020-02-07T012:03:37.000Z,M07331566,FT,2500,628752,DEBIT,VIN/indianoil/977913119116/576108671412,RFN13730270,2020-02-07
2020-02-08T018:34:12.000Z,M98083631,FT,1200,627552,DEBIT,UPI/966351868124/order/kwalitybazaar/okhdfcbank,RFN30626344,2020-02-08
2020-02-09T009:01:47.000Z,M63446577,FT,1299,626253,DEBIT,UPI/952275990633/order/ionbroadband/upi,RFN82019588,2020-02-09
2020-02-10T013:58:56.000Z,M66419846,FT,399,625854,DEBIT,UPI/067964917494/order/jio/okhdfcbank,RFN48699034,2020-02-10
2020-02-12T010:07:08.000Z,M50798447,FT,1800,624054,DEBIT,UPI/564392489740/order/gilly's/upi,RFN49766041,2020-02-12
2020-02-15T004:16:57.000Z,M41778052,FT,180,623874,DEBIT,UPI/689297266512/order/amul/ybl,RFN73746605,2020-02-15
2020-02-18T002:38:02.000Z,M27694781,FT,160,623714,DEBIT,UPI/356685660419/order/1mg/okaxis,RFN33362102,2020-02-18
2020-02-18T016:42:56.000Z,M29805358,FT,350,623364,DEBIT,VIN/tatasky/482626642123/532443363058,RFN49972633,2020-02-18
2020-02-22T023:23:47.000Z,M40621015,FT,799,622565,DEBIT,IIN/I-Debit/netflix/091258403727/146341709766,RFN09022036,2020-02-22
2020-02-25T007:02:09.000Z,M21117940,FT,50,622515,DEBIT,UPI/152981382144/order/amul/okaxis,RFN95283433,2020-02-25
2020-02-28T003:49:57.000Z,M50519900,FT,310,622205,DEBIT,UPI/744740313198/order/uber/oksbi,RFN52049060,2020-02-28
2020-02-28T014:33:52.000Z,M70001644,FT,1900,620305,DEBIT,UPI/651394309461/order/dentistclinic/okaxis,RFN70517083,2020-02-28
2020-02-28T017:17:31.000Z,M50412892,FT,330,619975,DEBIT,UPI/522657590187/order/uber/okaxis,RFN93239229,2020-02-28
2020-02-28T017:50:17.000Z,M99655836,FT,99,619876,DEBIT,UPI/553439743102/order/kwalitybazaar/okaxis,RFN28835823,2020-02-28
2020-02-28T005:58:25.000Z,M47374871,FT,25005,594871,DEBIT,MMT/IMPS/130665013482/axispriviledgeccpmt/axis/HDF,RFN19409833,2020-02-28
2020-02-28T018:08:27.000Z,M04419411,FT,15542,579329,DEBIT,MMT/IMPS/808747268346/sbieliteccpmt/axis/BLR,RFN63698862,2020-02-28
2020-03-01T021:09:32.000Z,M18224551,FT,120000,699329,CREDIT,salfintechproductsandsolutions March 2020,RFN88109470,2020-03-01
2020-03-01T018:35:03.000Z,M15345270,FT,3567,695762,DEBIT,ACH/maxlifeinsurance/876742690/2021260793,RFN05840315,2020-03-01
2020-03-01T008:21:46.000Z,M14638950,FT,11345,684417,DEBIT,MMT/IMPS/414443904497/pnbpersonalloan/axis/BLR,RFN22965072,2020-03-01
2020-03-01T014:53:05.000Z,M98396447,FT,11000,673417,DEBIT,BIL/ONL/566805825982/motilaloswal/3224298064,RFN30375494,2020-03-01
2020-03-01T007:41:15.000Z,M64723969,FT,10500,662917,DEBIT,BIL/BPAY/493086021310/principalmutualfund/4118773371,RFN30930854,2020-03-01
2020-03-02T011:19:34.000Z,M07947368,FT,240,662677,DEBIT,UPI/493830518554/order/amul/upi,RFN65465230,2020-03-02
2020-03-03T007:00:06.000Z,M78768594,FT,1536,661141,DEBIT,IPS/bigbasket/769711308170/030303998308/BANGALORE,RFN15890634,2020-03-03
2020-03-03T018:35:17.000Z,M85146597,FT,8832,652309,DEBIT,MMT/IMPS/702215184289/pnbpersonalloan/axis/HDF,RFN47273880,2020-03-03
2020-03-04T011:18:49.000Z,M48466293,FT,12000,640309,DEBIT,MMT/IMPS/930446756268/rent/axis/SIB,RFN21474903,2020-03-04
2020-03-04T016:46:17.000Z,M24105606,FT,242,640067,DEBIT,UPI/355596574964/order/leongrill/okaxis,RFN06178572,2020-03-04
2020-03-05T015:51:56.000Z,M19161023,FT,1561,638506,DEBIT,UPI/989738936106/order/bescom/ybl,RFN21799459,2020-03-05
2020-03-07T020:49:42.000Z,M62955584,FT,1500,637006,DEBIT,VIN/indianoil/564485376874/223117050224,RFN44121658,2020-03-07
2020-03-08T021:41:35.000Z,M11793716,FT,220,636786,DEBIT,UPI/983766366531/order/sriganeshmedical/upi,RFN52758894,2020-03-08
2020-03-09T010:23:36.000Z,M14098213,FT,1299,635487,DEBIT,UPI/794407042453/order/ionbroadband/okaxis,RFN56051691,2020-03-09
2020-03-11T020:03:51.000Z,M39962557,FT,30000,665487,CREDIT,BIL/ONL/063838379622/23435678032/7968689982,RFN69627088,2020-03-11
2020-03-12T023:43:40.000Z,M85404046,FT,13999,651488,DEBIT,VPS/amazon/829169860903/364771382096/Begaluru,RFN82609090,2020-03-12
2020-03-12T007:00:03.000Z,M27505612,FT,310,651178,DEBIT,IIN/I-Debit/a2b/277094276198/550639225030,RFN98636156,2020-03-12
2020-03-15T011:08:58.000Z,M06489616,FT,180,650998,DEBIT,UPI/492042578004/order/amul/okhdfcbank,RFN29251066,2020-03-15
2020-03-18T020:04:25.000Z,M80179068,FT,1400,649598,DEBIT,UPI/737033177231/order/myntra/upi,RFN18624359,2020-03-18
2020-03-18T002:31:32.000Z,M41086027,FT,350,649248,DEBIT,VIN/tatasky/038148094594/207618853296,RFN15043175,2020-03-18
2020-03-21T021:53:41.000Z,M49716585,FT,850,648398,DEBIT,VIN/bblunt/038507736881/013509488732,RFN75382114,2020-03-21
2020-03-22T002:07:53.000Z,M37965367,FT,799,647599,DEBIT,IIN/I-Debit/netflix/731033393195/945673654419,RFN13170703,2020-03-22
2020-03-28T016:58:35.000Z,M34413530,FT,29,647570,DEBIT,UPI/580249067735/order/kwalitybazaar/okicici,RFN13321663,2020-03-28
2020-03-31T002:31:52.000Z,M74906194,FT,25005,622565,DEBIT,MMT/IMPS/191893185064/axispriviledgeccpmt/axis/KIN,RFN23130807,2020-03-31
2020-03-31T012:02:48.000Z,M03086844,FT,15542,607023,DEBIT,MMT/IMPS/950873206576/sbieliteccpmt/axis/HDF,RFN37764525,2020-03-31
2020-04-01T001:04:26.000Z,M85071473,FT,120000,727023,CREDIT,salfintechproductsandsolutions April 2020,RFN89708585,2020-04-01
2020-04-01T002:28:45.000Z,M58863702,FT,3567,723456,DEBIT,ACH/maxlifeinsurance/635515327/4787109649,RFN67558985,2020-04-01
2020-04-01T022:16:59.000Z,M41517245,FT,11345,712111,DEBIT,MMT/IMPS/683315670320/pnbpersonalloan/axis/SIB,RFN28437602,2020-04-01
2020-04-01T021:32:55.000Z,M80231339,FT,8000,704111,DEBIT,BIL/BPAY/486484019104/motilaloswal/4451646581,RFN61892940,2020-04-01
2020-04-01T011:26:59.000Z,M43873535,FT,15500,688611,DEBIT,BIL/ONL/262067170023/principalmutualfund/1253116474,RFN57732619,2020-04-01
2020-04-02T018:29:08.000Z,M41603219,FT,670,687941,DEBIT,UPI/188064249465/order/mrgoofy's/okhdfcbank,RFN61305200,2020-04-02
2020-04-03T000:27:09.000Z,M75669446,FT,1983,685958,DEBIT,IPS/spencers/391596190943/871151881704/BANGALORE,RFN86503147,2020-04-03
2020-04-03T015:59:18.000Z,M33667145,FT,8832,677126,DEBIT,MMT/IMPS/422092848979/pnbpersonalloan/axis/SIB,RFN76168535,2020-04-03
2020-04-04T002:43:18.000Z,M94630944,FT,12000,665126,DEBIT,MMT/IMPS/591007285240/rent/axis/HDF,RFN43054083,2020-04-04
2020-04-04T000:25:13.000Z,M59898363,FT,667,664459,DEBIT,UPI/145863695123/order/zomato/okaxis,RFN82367505,2020-04-04
2020-04-05T013:45:22.000Z,M72538344,FT,560,663899,DEBIT,UPI/395495170472/order/uber/upi,RFN33137167,2020-04-05
2020-04-05T023:30:15.000Z,M06613176,FT,880,663019,DEBIT,UPI/378256659189/order/bescom/okicici,RFN28066955,2020-04-05
2020-04-05T000:53:09.000Z,M74599746,FT,20000,683019,CREDIT,BIL/ONL/326800836370/435456745323234353/9510979583,RFN59523304,2020-04-05
2020-04-07T015:49:15.000Z,M65661505,FT,2000,681019,DEBIT,VIN/indianoil/148751164676/447286665789,RFN80517416,2020-04-07
2020-04-08T009:22:28.000Z,M76656893,FT,1299,679720,DEBIT,UPI/849449893937/order/skybags/okaxis,RFN78500275,2020-04-08
2020-04-09T013:12:48.000Z,M74044333,FT,1299,678421,DEBIT,UPI/479354880825/order/ionbroadband/okhdfcbank,RFN40085097,2020-04-09
2020-04-12T002:54:00.000Z,M56163740,FT,7999,670422,DEBIT,VIN/titaneyeplus/406798179094/417253310368,RFN80541631,2020-04-12
2020-04-12T019:36:25.000Z,M46878884,FT,3500,666922,DEBIT,IPS/rahulkumar/406531096872/786620367060/BANGALORE,RFN58752641,2020-04-12
2020-04-15T011:27:44.000Z,M94281888,FT,380,666542,DEBIT,UPI/970739838838/order/amul/ybl,RFN59400381,2020-04-15
2020-04-18T005:25:06.000Z,M03643936,FT,2100,664442,DEBIT,VIN/only/169128449994/790876026477,RFN82079013,2020-04-18
2020-04-18T011:19:17.000Z,M23630688,FT,350,664092,DEBIT,VIN/tatasky/817983268987/743581322164,RFN80821078,2020-04-18
2020-04-22T020:07:53.000Z,M15610751,FT,799,663293,DEBIT,IIN/I-Debit/netflix/307688738628/547643083790,RFN17547478,2020-04-22
2020-04-24T014:53:55.000Z,M51124649,FT,499,662794,DEBIT,VPS/pvr/214903308692/856368216008/BLR,RFN35195904,2020-04-24
2020-04-25T000:24:31.000Z,M92699227,FT,1510,661284,DEBIT,UPI/537288169003/order/landmark/okicici,RFN56740097,2020-04-25
2020-04-28T019:57:35.000Z,M68582438,FT,789,660495,DEBIT,VPS/irctc/543743022182/162730615508/BENGALURU,RFN16340783,2020-04-28
2020-04-30T022:36:47.000Z,M15510398,FT,25005,635490,DEBIT,MMT/IMPS/079527241696/axispriviledgeccpmt/axis/HDF,RFN30941327,2020-04-30
2020-04-30T014:22:54.000Z,M04222531,FT,15542,619948,DEBIT,MMT/IMPS/265321081082/sbieliteccpmt/axis/SIB,RFN47041379,2020-04-30
2020-05-01T006:04:47.000Z,M90192812,FT,120000,739948,CREDIT,salfintechproductsandsolutions May 2020,RFN13313958,2020-05-01
2020-05-01T016:55:54.000Z,M15757030,FT,3567,736381,DEBIT,ACH/maxlifeinsurance/662360137/1446684660,RFN84589035,2020-05-01
2020-05-01T019:13:30.000Z,M03713577,FT,11345,725036,DEBIT,MMT/IMPS/440058590903/pnbpersonalloan/axis/SBIN,RFN70249395,2020-05-01
2020-05-01T013:45:43.000Z,M12243964,FT,11000,714036,DEBIT,BIL/BPAY/807146389536/motilaloswal/9724950382,RFN48862603,2020-05-01
2020-05-01T000:10:53.000Z,M34533087,FT,10500,703536,DEBIT,BIL/INF/494806886866/principalmutualfund/5561390064,RFN41280458,2020-05-01
2020-05-02T001:34:05.000Z,M02266776,FT,160,703376,DEBIT,UPI/673786962060/order/amul/upi,RFN50070206,2020-05-02
2020-05-03T023:23:02.000Z,M44322739,FT,3290,700086,DEBIT,IPS/spencers/501164660840/545710576613/BANGALORE,RFN01271238,2020-05-03
2020-05-03T006:16:44.000Z,M64507444,FT,8832,691254,DEBIT,MMT/IMPS/012958266470/pnbpersonalloan/axis/KIN,RFN73909692,2020-05-03
2020-05-04T002:58:09.000Z,M23499200,FT,12000,679254,DEBIT,MMT/IMPS/989953870885/rent/axis/KIN,RFN75657278,2020-05-04
2020-05-04T000:11:53.000Z,M45690999,FT,496,678758,DEBIT,VIN/eatfit/358869795612/964135050196,RFN00607765,2020-05-04
2020-05-04T006:06:00.000Z,M32922411,FT,6989,671769,DEBIT,VPS/h&m/027747869479/781796214338/BLR,RFN83279995,2020-05-04
2020-05-04T008:21:11.000Z,M53027470,FT,4503,667266,DEBIT,VPS/bangalorecentral/869235333340/212388211813/Begaluru,RFN36891482,2020-05-04
2020-05-05T015:35:02.000Z,M01341350,FT,402,666864,DEBIT,UPI/377092142836/order/uber/okaxis,RFN40441193,2020-05-05
2020-05-05T018:32:19.000Z,M23942591,FT,8472,658392,DEBIT,VIN/nolimmits/941107786633/442924801336,RFN00300937,2020-05-05
2020-05-05T003:51:35.000Z,M95273430,FT,442,657950,DEBIT,UPI/383880140922/order/uber/okhdfcbank,RFN29014416,2020-05-05
2020-05-05T000:37:07.000Z,M48183956,FT,1280,656670,DEBIT,UPI/394070918866/order/bescom/okaxis,RFN83223437,2020-05-05
2020-05-07T002:22:44.000Z,M61708024,FT,1500,655170,DEBIT,VIN/indianoil/254857982191/974390942346,RFN12082199,2020-05-07
2020-05-08T019:48:32.000Z,M52248216,FT,799,654371,DEBIT,UPI/349797744096/order/bblunt/okhdfcbank,RFN83518305,2020-05-08
2020-05-09T021:25:44.000Z,M88951078,FT,1299,653072,DEBIT,UPI/342075049056/order/ionbroadband/okhdfcbank,RFN86956116,2020-05-09
2020-05-10T020:52:37.000Z,M19468935,FT,399,652673,DEBIT,UPI/554121183971/order/jio/oksbi,RFN86614134,2020-05-10
2020-05-11T014:44:20.000Z,M68519005,FT,10000,662673,CREDIT,BIL/INF/386479331008/48282029013/1783470847,RFN60181875,2020-05-11
2020-05-12T014:35:57.000Z,M43955632,FT,3289,659384,DEBIT,VPS/gilly's/007229623931/862518302313/BENGALURU,RFN58357297,2020-05-12
2020-05-15T017:55:38.000Z,M57104316,FT,70,659314,DEBIT,UPI/549515369378/order/amul/okaxis,RFN25995417,2020-05-15
2020-05-18T002:34:33.000Z,M51740396,ATM,3500,655814,DEBIT,ATM/WVAKG952/CASH WDL/2020-05-18,RFN73197248,2020-05-18
2020-05-18T014:34:28.000Z,M85685452,FT,350,655464,DEBIT,VIN/tatasky/219667171536/249707112670,RFN09509018,2020-05-18
2020-05-22T013:07:46.000Z,M10974060,FT,799,654665,DEBIT,IIN/I-Debit/netflix/379146601014/080154882827,RFN39363675,2020-05-22
2020-05-24T011:56:50.000Z,M93093767,FT,299,654366,DEBIT,VPS/pvr/298637387611/323208486911/BENGALURU,RFN63158787,2020-05-24
2020-05-25T014:21:14.000Z,M64316588,ATM,1000,653366,DEBIT,ATM/FNTLM932/CASH WDL/2020-05-25,RFN40129856,2020-05-25
2020-05-28T004:22:31.000Z,M36166885,FT,99,653267,DEBIT,UPI/904722538104/order/kwalitybazaar/ybl,RFN49292850,2020-05-28
2020-05-31T022:29:11.000Z,M93651566,FT,25005,628262,DEBIT,MMT/IMPS/175180899032/axispriviledgeccpmt/axis/KIN,RFN36412496,2020-05-31
2020-05-31T017:43:16.000Z,M39854813,FT,15542,612720,DEBIT,MMT/IMPS/211910652383/sbieliteccpmt/axis/KIN,RFN23263362,2020-05-31
2020-06-01T003:31:27.000Z,M24980343,FT,120000,732720,CREDIT,salfintechproductsandsolutions June 2020,RFN30507987,2020-06-01
2020-06-01T023:21:16.000Z,M49667261,FT,3567,729153,DEBIT,ACH/maxlifeinsurance/879401931/8297585673,RFN48498897,2020-06-01
2020-06-01T011:21:06.000Z,M80568137,FT,11345,717808,DEBIT,MMT/IMPS/697656407341/pnbpersonalloan/axis/SIB,RFN57852266,2020-06-01
2020-06-01T020:59:16.000Z,M82489418,FT,6000,711808,DEBIT,BIL/BPAY/978238002072/motilaloswal/7885724313,RFN45710428,2020-06-01
2020-06-01T013:28:01.000Z,M44113740,FT,14000,697808,DEBIT,BIL/ONL/163462434231/principalmutualfund/1660110269,RFN93974938,2020-06-01
2020-06-02T023:31:47.000Z,M13604205,FT,89000,608808,DEBIT,VIN/iplanet/176200633291/851167020065,RFN48066261,2020-06-02
2020-06-03T011:00:18.000Z,M28938864,FT,1200,607608,DEBIT,IPS/bigbasket/664373708096/667284233087/BANGALORE,RFN40183415,2020-06-03
2020-06-03T005:16:09.000Z,M92848950,FT,8832,598776,DEBIT,MMT/IMPS/207976766869/pnbpersonalloan/axis/HDF,RFN52936270,2020-06-03
2020-06-04T015:03:59.000Z,M70737616,FT,12000,586776,DEBIT,MMT/IMPS/025587122063/rent/axis/BLR,RFN20510702,2020-06-04
2020-06-04T022:35:22.000Z,M77151077,FT,249,586527,DEBIT,VIN/kfc/156475819407/202299172234,RFN97149636,2020-06-04
2020-06-05T023:02:53.000Z,M99186255,FT,120,586407,DEBIT,UPI/289615948630/order/uber/oksbi,RFN70576827,2020-06-05
2020-06-05T000:53:32.000Z,M68918754,FT,1480,584927,DEBIT,UPI/444282210642/order/bescom/okaxis,RFN68033483,2020-06-05
2020-06-07T014:03:04.000Z,M66932610,FT,2110,582817,DEBIT,UPI/917270647847/order/plated/upi,RFN65378083,2020-06-07
2020-06-08T021:21:03.000Z,M80287904,ATM,2000,580817,DEBIT,ATM/RRCET224/CASH WDL/2020-06-08,RFN55622565,2020-06-08
2020-06-08T003:49:56.000Z,M91816893,FT,3080,577737,DEBIT,VIN/landmark/093800044711/378504219088,RFN86422483,2020-06-08
2020-06-09T020:33:06.000Z,M19222016,FT,1299,576438,DEBIT,UPI/495945245180/order/ionbroadband/ybl,RFN13690549,2020-06-09
2020-06-12T020:48:53.000Z,M50139266,FT,9999,566439,DEBIT,VPS/adidas/707608010746/530720158923/BLR,RFN86859546,2020-06-12
2020-06-12T004:55:50.000Z,M35696102,FT,230,566209,DEBIT,UPI/757298673658/order/eatfit/okhdfcbank,RFN43937498,2020-06-12
2020-06-15T003:58:38.000Z,M94149898,FT,210,565999,DEBIT,UPI/199372163851/order/amul/okicici,RFN86369901,2020-06-15
2020-06-18T006:48:29.000Z,M87347402,FT,599,565400,DEBIT,UPI/881115406349/order/croma/okicici,RFN88877391,2020-06-18
2020-06-18T021:52:51.000Z,M27251188,FT,350,565050,DEBIT,VIN/tatasky/988692836942/325913546607,RFN73059090,2020-06-18
2020-06-19T013:18:30.000Z,M54451193,FT,5000,570050,CREDIT,BIL/ONL/715848431993/0292192233/2094609344,RFN57694406,2020-06-19
2020-06-19T002:03:49.000Z,M13315793,FT,7000,577050,CREDIT,BIL/INF/488362821725/0324830223/0218457556,RFN11784281,2020-06-19
2020-06-22T019:55:51.000Z,M98799975,FT,799,576251,DEBIT,IIN/I-Debit/netflix/629461873465/530120646868,RFN92605397,2020-06-22
2020-06-28T017:48:47.000Z,M82846696,FT,59,576192,DEBIT,UPI/256914290447/order/kwalitybazaar/oksbi,RFN89520634,2020-06-28
2020-06-30T012:53:29.000Z,M27519313,FT,25005,551187,DEBIT,MMT/IMPS/085126844062/axispriviledgeccpmt/axis/SBIN,RFN55050069,2020-06-30
2020-06-30T017:14:01.000Z,M21789114,FT,15542,535645,DEBIT,MMT/IMPS/088907102871/sbieliteccpmt/axis/BLR,RFN66533185,2020-06-30
2020-07-01T002:35:12.000Z,M56192555,FT,120000,655645,CREDIT,salfintechproductsandsolutions July 2020,RFN24815025,2020-07-01
2020-07-01T018:10:34.000Z,M66752042,FT,3567,652078,DEBIT,ACH/maxlifeinsurance/253611798/3198235440,RFN16386719,2020-07-01
2020-07-01T007:53:05.000Z,M20462573,FT,11345,640733,DEBIT,MMT/IMPS/439941465324/pnbpersonalloan/axis/SIB,RFN40529813,2020-07-01
2020-07-01T023:47:27.000Z,M46684360,FT,15000,625733,DEBIT,BIL/BPAY/355943500886/motilaloswal/7188063427,RFN54412944,2020-07-01
2020-07-01T003:39:38.000Z,M74788369,FT,14000,611733,DEBIT,BIL/BPAY/145251653209/principalmutualfund/3391403074,RFN52770617,2020-07-01
2020-07-02T008:01:15.000Z,M44519950,FT,230,611503,DEBIT,UPI/440539031048/order/amul/okhdfcbank,RFN68706095,2020-07-02
2020-07-03T006:13:15.000Z,M48425205,FT,1599,609904,DEBIT,IPS/spencers/581424178244/811763871197/BANGALORE,RFN36431379,2020-07-03
2020-07-03T009:02:51.000Z,M63329120,FT,8832,601072,DEBIT,MMT/IMPS/754200341622/pnbpersonalloan/axis/KIN,RFN92288002,2020-07-03
2020-07-04T014:08:33.000Z,M82545568,FT,12000,589072,DEBIT,MMT/IMPS/469109294447/rent/axis/KIN,RFN33256050,2020-07-04
2020-07-04T004:42:18.000Z,M59024068,FT,242,588830,DEBIT,VIN/burgerking/951158645836/784614233750,RFN32077276,2020-07-04
2020-07-05T017:15:46.000Z,M23281042,FT,540,588290,DEBIT,UPI/605873963318/order/kfc/ybl,RFN25935058,2020-07-05
2020-07-05T013:03:09.000Z,M95177329,FT,1542,586748,DEBIT,UPI/235430538930/order/bescom/okhdfcbank,RFN33888840,2020-07-05
2020-07-07T004:32:37.000Z,M91366549,FT,2400,584348,DEBIT,VIN/indianoil/436414714760/884483531478,RFN00026246,2020-07-07
2020-07-08T014:52:21.000Z,M85794181,FT,3598,580750,DEBIT,UPI/455838199939/order/landmark/okhdfcbank,RFN60073145,2020-07-08
2020-07-09T011:08:54.000Z,M86995637,FT,1299,579451,DEBIT,UPI/780772604596/order/ionbroadband/oksbi,RFN76260080,2020-07-09
2020-07-12T020:34:00.000Z,M94678826,FT,2889,576562,DEBIT,VPS/veromoda/705934583257/800756883522/BENGALURU,RFN45546146,2020-07-12
2020-07-12T006:59:38.000Z,M01788012,FT,410,576152,DEBIT,UPI/958942939285/order/eatfit/okaxis,RFN31854765,2020-07-12
2020-07-15T008:40:33.000Z,M32928584,FT,790,575362,DEBIT,UPI/850981385289/order/beijingbites/okaxis,RFN74920276,2020-07-15
2020-07-16T022:56:26.000Z,M76266319,FT,30000,605362,CREDIT,BIL/INF/987769904120/323455920392/2731284123,RFN34700638,2020-07-16
2020-07-18T020:22:10.000Z,M15477755,FT,3999,601363,DEBIT,UPI/913318536802/order/bangalorecentral/okicici,RFN20551313,2020-07-18
2020-07-18T002:44:34.000Z,M58855630,FT,350,601013,DEBIT,VIN/tatasky/935068634586/769678492618,RFN47111662,2020-07-18
2020-07-22T015:46:57.000Z,M88059061,FT,799,600214,DEBIT,IIN/I-Debit/netflix/389037394438/927817251494,RFN22917795,2020-07-22
2020-07-24T015:02:57.000Z,M92571508,FT,450,599764,DEBIT,VPS/pvr/975816729244/789310256379/BLR,RFN66707645,2020-07-24
2020-07-25T005:30:50.000Z,M10333567,FT,50,599714,DEBIT,UPI/278594832508/order/amul/okicici,RFN56653970,2020-07-25
2020-07-28T005:30:02.000Z,M94408675,FT,120,599594,DEBIT,UPI/605712553606/order/kwalitybazaar/okaxis,RFN47965150,2020-07-28
2020-07-31T015:49:03.000Z,M12938836,FT,25005,574589,DEBIT,MMT/IMPS/939367005356/axispriviledgeccpmt/axis/SIB,RFN02082036,2020-07-31
2020-07-31T000:33:02.000Z,M37720499,FT,15542,559047,DEBIT,MMT/IMPS/571015459530/sbieliteccpmt/axis/HDF,RFN87487275,2020-07-31
2020-07-31T005:50:41.000Z,M98091337,ATM,5000,554047,DEBIT,ATM/ZMNVD036/CASH WDL/2020-07-31,RFN45102508,2020-07-31
