transactionTimestamp,txnId,mode,amount,balance,type,narration,reference,valueDate
2019-08-01T009:09:53.000Z,M76286556,FT,150000,539769,CREDIT,salfintechproductsandsolutions August 2019,RFN89641029,2019-08-01
2019-08-01T012:39:54.000Z,M46580318,FT,3567,536202,DEBIT,ACH/maxlifeinsurance/396417922/7471502728,RFN60198659,2019-08-01
2019-08-01T009:49:47.000Z,M23479444,FT,5000,531202,DEBIT,BIL/ONL/630122606082/motilaloswal/5356058284,RFN61938043,2019-08-01
2019-08-01T005:48:49.000Z,M45019871,FT,9000,522202,DEBIT,BIL/ONL/082876897051/principalmutualfund/2284176430,RFN44090258,2019-08-01
2019-08-01T000:29:41.000Z,M14713176,FT,11345,510857,DEBIT,MMT/IMPS/819718473217/pnbpersonalloan/axis/BLR,RFN64791200,2019-08-01
2019-08-02T017:44:24.000Z,M77915402,FT,50,510807,DEBIT,UPI/812245710641/order/amul/upi,RFN85203199,2019-08-02
2019-08-03T019:46:51.000Z,M52719168,FT,2231,508576,DEBIT,IPS/spencers/707162124847/571842432911/BANGALORE,RFN90634044,2019-08-03
2019-08-03T008:30:32.000Z,M15143660,FT,14583,493993,DEBIT,MMT/IMPS/848859383813/idbihomeloan/axis/SIB,RFN33801694,2019-08-03
2019-08-04T006:15:55.000Z,M93164734,FT,12000,481993,DEBIT,MMT/IMPS/604509997485/rent/axis/BLR,RFN30864431,2019-08-04
2019-08-04T016:49:33.000Z,M04862680,FT,242,481751,DEBIT,VIN/burgerking/154266572843/660580276483,RFN92569911,2019-08-04
2019-08-05T014:11:10.000Z,M64453498,FT,330,481421,DEBIT,UPI/917186416106/order/uber/upi,RFN50266621,2019-08-05
2019-08-05T006:03:15.000Z,M55753663,FT,1380,480041,DEBIT,UPI/451639070455/order/bescom/okaxis,RFN62302913,2019-08-05
2019-08-07T000:22:42.000Z,M48126707,FT,1500,478541,DEBIT,VIN/indianoil/042058443125/493851026694,RFN97033233,2019-08-07
2019-08-08T002:35:02.000Z,M72799685,FT,200,478341,DEBIT,UPI/632403497106/order/kwalitybazaar/okaxis,RFN96925397,2019-08-08
2019-08-09T018:29:55.000Z,M76311781,FT,1299,477042,DEBIT,UPI/061384951603/order/ionbroadband/okhdfcbank,RFN19024553,2019-08-09
2019-08-10T014:21:36.000Z,M37452988,FT,399,476643,DEBIT,UPI/137529468491/order/jio/upi,RFN13785054,2019-08-10
2019-08-12T013:26:00.000Z,M24744818,FT,3289,473354,DEBIT,VPS/veromoda/653932469482/372139863314/BANGALORE,RFN72558628,2019-08-12
2019-08-12T015:44:34.000Z,M42632880,FT,1110,472244,DEBIT,IPS/beijingbites/804398888251/363033573457/BANGALORE,RFN10620226,2019-08-12
2019-08-15T015:17:52.000Z,M34718675,FT,180,472064,DEBIT,UPI/687900902232/order/amul/okaxis,RFN03570307,2019-08-15
2019-08-18T011:48:04.000Z,M82585579,FT,419,471645,DEBIT,UPI/565522170197/order/1mg/okicici,RFN29834866,2019-08-18
2019-08-18T015:15:23.000Z,M77608604,FT,350,471295,DEBIT,VIN/tatasky/693745791889/243404116417,RFN94710970,2019-08-18
2019-08-22T016:59:04.000Z,M71560249,FT,799,470496,DEBIT,IIN/I-Debit/netflix/707266544044/702060430869,RFN67872209,2019-08-22
2019-08-24T011:20:03.000Z,M23076420,FT,299,470197,DEBIT,VPS/pvr/704876744412/317128816899/BANGALORE,RFN59950387,2019-08-24
2019-08-25T001:12:34.000Z,M32114105,FT,150,470047,DEBIT,UPI/618517696860/order/amul/ybl,RFN13403010,2019-08-25
2019-08-28T011:53:16.000Z,M79354893,FT,5201,464846,DEBIT,ACH/indiafirstlifeinsurance/622103789/3391289361,RFN27768591,2019-08-28
2019-08-28T000:45:41.000Z,M49647341,FT,99,464747,DEBIT,UPI/931624258370/order/kwalitybazaar/upi,RFN92567237,2019-08-28
2019-08-31T004:45:36.000Z,M57896440,FT,25005,439742,DEBIT,MMT/IMPS/655469539510/axisprivilegeccpmt/axis/HDF,RFN05536678,2019-08-31
2019-08-31T008:10:23.000Z,M25642407,FT,15542,424200,DEBIT,MMT/IMPS/087080479801/sbieliteccpmt/axis/KIN,RFN23143869,2019-08-31
2019-09-01T008:51:08.000Z,M31474501,FT,150000,574200,CREDIT,salfintechproductsandsolutions September 2019,RFN51651094,2019-09-01
2019-09-01T011:41:05.000Z,M66466054,FT,3567,570633,DEBIT,ACH/maxlifeinsurance/344892100/0527204852,RFN11534170,2019-09-01
2019-09-01T005:23:45.000Z,M19686751,FT,11345,559288,DEBIT,MMT/IMPS/154561117657/pnbpersonalloan/axis/KIN,RFN21312787,2019-09-01
2019-09-01T019:25:12.000Z,M24482268,FT,5000,554288,DEBIT,BIL/BPAY/677109147766/motilaloswal/1656888598,RFN35281191,2019-09-01
2019-09-01T022:53:56.000Z,M35371409,FT,9000,545288,DEBIT,BIL/INF/815795968613/principalmutualfund/1037878998,RFN92928504,2019-09-01
2019-09-03T005:27:55.000Z,M04074410,FT,80,545208,DEBIT,UPI/470474926432/order/skrolls/upi,RFN28355461,2019-09-03
2019-09-03T018:57:33.000Z,M39197252,FT,100,545108,DEBIT,UPI/250714865110/order/amul/oksbi,RFN60471884,2019-09-03
2019-09-03T002:30:39.000Z,M71263095,FT,1588,543520,DEBIT,IPS/spencers/742738601457/538689353441/BANGALORE,RFN60501929,2019-09-03
2019-09-03T023:34:32.000Z,M74196138,FT,14583,528937,DEBIT,MMT/IMPS/663164387269/idbihomeloan/axis/BLR,RFN33016880,2019-09-03
2019-09-04T011:55:23.000Z,M54467203,FT,12000,516937,DEBIT,MMT/IMPS/572864709170/rent/axis/SIB,RFN27033602,2019-09-04
2019-09-05T022:23:18.000Z,M39740700,FT,898,516039,DEBIT,VIN/beijingbites/625882713233/719071070134,RFN20313590,2019-09-05
2019-09-05T006:47:37.000Z,M31456407,FT,3500,519539,CREDIT,BIL/BPAY/851472771057/994302139330/8732748151,RFN87671592,2019-09-05
2019-09-05T006:24:32.000Z,M79021120,FT,1680,517859,DEBIT,UPI/186975138694/order/bescom/oksbi,RFN30238138,2019-09-05
2019-09-06T002:47:25.000Z,M51013764,FT,459,517400,DEBIT,VPS/pvr/327818715743/891145516491/Begaluru,RFN30793478,2019-09-06
2019-09-08T014:34:37.000Z,M07454864,FT,100,517300,DEBIT,UPI/486619996038/order/kwalitybazaar/oksbi,RFN14210132,2019-09-08
2019-09-08T004:57:50.000Z,M66421723,FT,80,517220,DEBIT,UPI/994886060663/order/amul/ybl,RFN70662783,2019-09-08
2019-09-09T008:17:12.000Z,M25921631,FT,1299,515921,DEBIT,UPI/312336033143/order/ionbroadband/upi,RFN35396700,2019-09-09
2019-09-12T001:17:02.000Z,M23482322,FT,420,515501,DEBIT,VPS/eatfit/498744383190/271393526276/bangalore,RFN87449779,2019-09-12
2019-09-12T004:47:24.000Z,M98041659,FT,14394,501107,DEBIT,IPS/cleartrip/812768071830/925841086540/BANGALORE,RFN46816829,2019-09-12
2019-09-15T001:13:29.000Z,M68508008,FT,150,500957,DEBIT,UPI/957019434789/order/bblunt/ybl,RFN48980060,2019-09-15
2019-09-17T017:48:39.000Z,M71879805,FT,1400,499557,DEBIT,VIN/bluo/215853580696/522580422050,RFN07787899,2019-09-17
2019-09-18T004:18:43.000Z,M77855269,FT,419,499138,DEBIT,UPI/342424435904/order/chaipoint/ybl,RFN94203245,2019-09-18
2019-09-18T020:36:21.000Z,M65727808,FT,350,498788,DEBIT,VIN/tatasky/309308330846/646368084693,RFN95114009,2019-09-18
2019-09-22T023:49:03.000Z,M34594716,FT,799,497989,DEBIT,IIN/I-Debit/netflix/464143274958/550334690198,RFN11126558,2019-09-22
2019-09-24T014:23:32.000Z,M69019727,FT,399,497590,DEBIT,VPS/pvr/447497479964/180180844373/Begaluru,RFN92896200,2019-09-24
2019-09-24T012:58:18.000Z,M91479299,FT,129,497461,DEBIT,UPI/552161607553/order/uber/upi,RFN02874602,2019-09-24
2019-09-28T003:30:40.000Z,M67690723,FT,5201,492260,DEBIT,ACH/indiafirstlifeinsurance/540066810/4607283752,RFN15829120,2019-09-28
2019-09-28T017:42:14.000Z,M23985207,FT,702,491558,DEBIT,UPI/705645655269/order/kwalitybazaar/upi,RFN86095588,2019-09-28
2019-09-30T011:23:45.000Z,M63687939,FT,25005,466553,DEBIT,MMT/IMPS/889875097371/axisprivilegeccpmt/axis/HDF,RFN55083771,2019-09-30
2019-09-30T008:01:46.000Z,M34251021,FT,205,466348,DEBIT,UPI/719037919042/order/amazon/okaxis,RFN09273274,2019-09-30
2019-09-30T018:15:47.000Z,M05365828,FT,15542,450806,DEBIT,MMT/IMPS/969478631747/sbieliteccpmt/axis/SBIN,RFN73368744,2019-09-30
2019-09-30T005:46:31.000Z,M22065853,ATM,10000,440806,DEBIT,ATM/FGSJR161/CASH WDL/2019-09-30,RFN97103477,2019-09-30
2019-10-01T018:53:15.000Z,M69139040,FT,150000,590806,CREDIT,salfintechproductsandsolutions October 2019,RFN40230711,2019-10-01
2019-10-01T004:20:07.000Z,M42830208,FT,3567,587239,DEBIT,ACH/maxlifeinsurance/857257158/2432043818,RFN61669155,2019-10-01
2019-10-01T013:58:26.000Z,M83559458,FT,11345,575894,DEBIT,MMT/IMPS/275412514542/pnbpersonalloan/axis/KIN,RFN88727457,2019-10-01
2019-10-01T015:21:12.000Z,M05808849,FT,5000,570894,DEBIT,BIL/BPAY/402166365737/motilaloswal/2627842137,RFN69338948,2019-10-01
2019-10-01T018:30:17.000Z,M34984904,FT,9000,561894,DEBIT,BIL/ONL/541985934892/principalmutualfund/7021544407,RFN39149373,2019-10-01
2019-10-02T015:36:48.000Z,M24061453,FT,560,561334,DEBIT,UPI/826083599226/order/kfc/ybl,RFN56629972,2019-10-02
2019-10-03T008:03:32.000Z,M91535059,FT,560,560774,DEBIT,IPS/pvr/370043050341/048343841737/BANGALORE,RFN13717519,2019-10-03
2019-10-03T012:01:16.000Z,M64761510,FT,14583,546191,DEBIT,MMT/IMPS/118608359041/idbihomeloan/axis/KIN,RFN23743161,2019-10-03
2019-10-04T020:57:07.000Z,M61678935,FT,12000,534191,DEBIT,MMT/IMPS/241887691995/rent/axis/BLR,RFN98696391,2019-10-04
2019-10-04T010:04:03.000Z,M41410726,FT,3500,530691,DEBIT,VIN/veromoda/027777759012/604983023830,RFN35943716,2019-10-04
2019-10-04T016:56:02.000Z,M69378736,FT,7500,523191,DEBIT,VIN/adidas/633705531768/811087789430,RFN31801845,2019-10-04
2019-10-04T003:15:23.000Z,M74384826,FT,280,522911,DEBIT,UPI/101740906294/order/uber/ybl,RFN99372691,2019-10-04
2019-10-05T022:30:22.000Z,M83644926,FT,1140,521771,DEBIT,UPI/694677507822/order/bescom/ybl,RFN73937957,2019-10-05
2019-10-07T015:56:07.000Z,M29223520,FT,2000,519771,DEBIT,VIN/indianoil/884003034462/070984774385,RFN50950977,2019-10-07
2019-10-08T012:52:39.000Z,M36316870,FT,1200,518571,DEBIT,UPI/283011513138/order/kwalitybazaar/oksbi,RFN21632399,2019-10-08
2019-10-10T015:01:01.000Z,M81228424,FT,1299,517272,DEBIT,UPI/673603914297/order/ionbroadband/okicici,RFN56899623,2019-10-10
2019-10-12T018:41:48.000Z,M31459153,FT,130,517142,DEBIT,UPI/563543433765/order/amul/okhdfcbank,RFN20618764,2019-10-12
2019-10-12T017:29:07.000Z,M17282229,FT,1510,515632,DEBIT,IPS/beijingbites/399238915646/993150526510/BANGALORE,RFN97476211,2019-10-12
2019-10-12T013:27:13.000Z,M65200889,FT,1240,514392,DEBIT,UPI/833247091812/order/sugar/oksbi,RFN61231812,2019-10-12
2019-10-13T007:28:48.000Z,M84638749,FT,6599,507793,DEBIT,VIN/nolimmits/961905744901/724057891008,RFN18693808,2019-10-13
2019-10-13T015:36:56.000Z,M38937296,FT,830,506963,DEBIT,UPI/319820635436/order/uber/okicici,RFN51274940,2019-10-13
2019-10-14T002:22:32.000Z,M39290526,FT,180,506783,DEBIT,UPI/821001161744/order/amul/okicici,RFN05537382,2019-10-14
2019-10-14T017:37:56.000Z,M15748744,FT,100,506683,DEBIT,UPI/633872892875/order/amul/okaxis,RFN98261988,2019-10-14
2019-10-18T007:11:02.000Z,M38184792,FT,350,506333,DEBIT,VIN/tatasky/605600950559/362705985622,RFN15568915,2019-10-18
2019-10-22T001:53:46.000Z,M98256417,FT,799,505534,DEBIT,IIN/I-Debit/netflix/225761600952/208539270882,RFN46499816,2019-10-22
2019-10-24T015:05:53.000Z,M06847798,FT,299,505235,DEBIT,VPS/pvr/741505304732/865429082747/bangalore,RFN24981952,2019-10-24
2019-10-25T011:19:17.000Z,M63688939,FT,270,504965,DEBIT,UPI/024564788336/order/swiggy/okhdfcbank,RFN13964509,2019-10-25
2019-10-26T005:51:29.000Z,M28455921,FT,2700,502265,DEBIT,VIN/indianoil/134918956845/424835318818,RFN07904551,2019-10-26
2019-10-26T006:19:20.000Z,M10774290,FT,2021,504286,CREDIT,BIL/INF/898951799308/233488841023/3747704560,RFN39595461,2019-10-26
2019-10-28T019:46:38.000Z,M84504032,FT,5201,499085,DEBIT,ACH/indiafirstlifeinsurance/479486408/1300618704,RFN22794678,2019-10-28
2019-10-28T004:21:27.000Z,M03469083,FT,2001,497084,DEBIT,UPI/680058090202/order/decathlon/okaxis,RFN86273536,2019-10-28
2019-10-28T009:16:44.000Z,M05242139,FT,1900,495184,DEBIT,IPS/dentistclinic/045089578420/114503766660/BANGALORE,RFN24858956,2019-10-28
2019-10-31T016:03:37.000Z,M72147145,FT,25005,470179,DEBIT,MMT/IMPS/593170893905/axisprivilegeccpmt/axis/HDF,RFN72920698,2019-10-31
2019-10-31T018:38:28.000Z,M61494722,FT,15542,454637,DEBIT,MMT/IMPS/750329297906/sbieliteccpmt/axis/SIB,RFN45780319,2019-10-31
2019-11-01T019:47:41.000Z,M94085107,FT,150000,604637,CREDIT,salfintechproductsandsolutions November 2019,RFN43327238,2019-11-01
2019-11-01T013:58:59.000Z,M16211304,FT,3567,601070,DEBIT,ACH/maxlifeinsurance/106232850/0334326988,RFN70008003,2019-11-01
2019-11-01T000:00:09.000Z,M12877108,FT,11345,589725,DEBIT,MMT/IMPS/111001365073/pnbpersonalloan/axis/SIB,RFN90524170,2019-11-01
2019-11-01T021:14:36.000Z,M78979826,FT,5000,584725,DEBIT,BIL/BPAY/772963857691/motilaloswal/7431658240,RFN19158570,2019-11-01
2019-11-01T014:20:38.000Z,M05151221,FT,9000,575725,DEBIT,BIL/ONL/722883469654/principalmutualfund/6184642515,RFN17949825,2019-11-01
2019-11-02T016:05:39.000Z,M87546544,FT,70,575655,DEBIT,UPI/773080227515/order/amul/ybl,RFN60946926,2019-11-02
2019-11-03T000:32:47.000Z,M40158427,FT,2730,572925,DEBIT,IPS/spencers/943952440403/709084817274/BANGALORE,RFN22759969,2019-11-03
2019-11-03T001:47:09.000Z,M84883337,FT,14583,558342,DEBIT,MMT/IMPS/762149594751/idbihomeloan/axis/KIN,RFN87225072,2019-11-03
2019-11-04T013:39:07.000Z,M38214924,FT,12000,546342,DEBIT,MMT/IMPS/687777348419/rent/axis/BLR,RFN56558256,2019-11-04
2019-11-04T022:16:28.000Z,M47856167,FT,890,545452,DEBIT,VIN/kfc/816048889143/492103750843,RFN59177388,2019-11-04
2019-11-04T021:27:14.000Z,M53175932,FT,799,544653,DEBIT,VIN/bblunt/753493474918/986262963589,RFN14029373,2019-11-04
2019-11-05T016:07:26.000Z,M78077345,FT,2999,541654,DEBIT,UPI/221701944566/order/indianoil/ybl,RFN10576530,2019-11-05
2019-11-05T023:46:40.000Z,M37551085,FT,1654,540000,DEBIT,UPI/046114728300/order/bescom/upi,RFN78638994,2019-11-05
2019-11-07T023:17:45.000Z,M29160959,FT,1500,538500,DEBIT,VIN/indianoil/632989350659/233463989322,RFN60639181,2019-11-07
2019-11-08T023:31:19.000Z,M86989853,FT,240,538260,DEBIT,UPI/626205095318/order/kwalitybazaar/okicici,RFN08751668,2019-11-08
2019-11-11T022:50:33.000Z,M17625869,FT,1299,536961,DEBIT,UPI/636141016988/order/ionbroadband/okicici,RFN59642445,2019-11-11
2019-11-10T021:13:07.000Z,M76488902,FT,399,536562,DEBIT,UPI/694169644420/order/jio/ybl,RFN09616808,2019-11-10
2019-11-12T014:12:12.000Z,M42080180,FT,333,536229,DEBIT,UPI/838732431652/order/uber/ybl,RFN57509577,2019-11-12
2019-11-12T015:59:14.000Z,M60455169,FT,2508,533721,DEBIT,IPS/gilly's/367484357488/514569651019/BANGALORE,RFN40298288,2019-11-12
2019-11-12T022:21:26.000Z,M93870045,FT,339,533382,DEBIT,UPI/604778531056/order/uber/okicici,RFN90476956,2019-11-12
2019-11-15T016:11:26.000Z,M58969218,FT,130,533252,DEBIT,UPI/231882167507/order/1mg/okhdfcbank,RFN67119471,2019-11-15
2019-11-15T018:00:43.000Z,M72969191,FT,3019,536271,CREDIT,BIL/ONL/702618503087/94320092/0933699919,RFN35235806,2019-11-15
2019-11-18T001:17:00.000Z,M92292284,FT,2019,534252,DEBIT,UPI/375945725401/order/oriflame/oksbi,RFN69317309,2019-11-18
2019-11-18T007:10:11.000Z,M47368366,FT,350,533902,DEBIT,VIN/tatasky/708515153158/184707024851,RFN47566137,2019-11-18
2019-11-22T020:26:14.000Z,M77422705,FT,799,533103,DEBIT,IIN/I-Debit/netflix/856109027664/906472607997,RFN97854727,2019-11-22
2019-11-24T007:07:01.000Z,M58359454,FT,540,532563,DEBIT,VPS/pvr/706084011988/890799090508/BANGALOR,RFN77781435,2019-11-24
2019-11-25T019:12:41.000Z,M57716448,FT,150,532413,DEBIT,UPI/434671210712/order/amul/okhdfcbank,RFN80719027,2019-11-25
2019-11-26T013:20:06.000Z,M49944925,FT,3500,528913,DEBIT,VIN/tonique/254143174345/872242030508,RFN31162088,2019-11-26
2019-11-26T007:41:02.000Z,M80567730,FT,2034,526879,DEBIT,VIN/spencer/404010839790/560371771891,RFN39092814,2019-11-26
2019-11-28T023:22:17.000Z,M80777120,FT,5201,521678,DEBIT,ACH/indiafirstlifeinsurance/825301878/4737828362,RFN65481607,2019-11-28
2019-11-28T011:44:28.000Z,M13188730,FT,1900,519778,DEBIT,UPI/689869847134/order/dentistclinic/okicici,RFN62338993,2019-11-28
2019-11-30T002:33:23.000Z,M40523807,FT,25005,494773,DEBIT,MMT/IMPS/656089906551/axisprivilegeccpmt/axis/KIN,RFN74864284,2019-11-30
2019-11-30T013:21:59.000Z,M99611183,FT,15542,479231,DEBIT,MMT/IMPS/081043577519/sbieliteccpmt/axis/SIB,RFN00422693,2019-11-30
2019-12-01T010:04:12.000Z,M94350595,FT,150000,629231,CREDIT,salfintechproductsandsolutions December 2019,RFN44443495,2019-12-01
2019-12-01T020:42:53.000Z,M08436217,FT,3567,625664,DEBIT,ACH/maxlifeinsurance/813492832/6801733648,RFN79238977,2019-12-01
2019-12-01T008:33:36.000Z,M69923492,FT,11345,614319,DEBIT,MMT/IMPS/764606460062/pnbpersonalloan/axis/HDF,RFN02323152,2019-12-01
2019-12-01T007:22:12.000Z,M33934013,FT,5000,609319,DEBIT,BIL/ONL/177563636627/motilaloswal/8433645775,RFN05361092,2019-12-01
2019-12-01T020:20:25.000Z,M85979860,FT,9000,600319,DEBIT,BIL/INF/562663741766/principalmutualfund/7728431273,RFN90711815,2019-12-01
2019-12-02T020:35:11.000Z,M63684060,FT,80,600239,DEBIT,UPI/675375885840/order/amul/okhdfcbank,RFN67382072,2019-12-02
2019-12-03T015:58:46.000Z,M18792126,FT,1409,598830,DEBIT,IPS/spencers/625976218404/232625138213/BANGALORE,RFN54438949,2019-12-03
2019-12-03T003:52:42.000Z,M51136111,FT,14583,584247,DEBIT,MMT/IMPS/467064488326/idbihomeloan/axis/BLR,RFN17205706,2019-12-03
2019-12-04T017:42:54.000Z,M02621811,FT,12000,572247,DEBIT,MMT/IMPS/350709599971/rent/axis/BLR,RFN06975546,2019-12-04
2019-12-04T010:39:07.000Z,M52862583,FT,242,572005,DEBIT,VIN/burgerking/829731701772/222198574310,RFN02244172,2019-12-04
2019-12-04T001:41:09.000Z,M48966271,FT,597,571408,DEBIT,UPI/863936093244/order/cafecofffeeday/okhdfcbank,RFN61332645,2019-12-04
2019-12-05T019:22:26.000Z,M15445292,FT,540,570868,DEBIT,UPI/985998268352/order/kwalitybazaar/upi,RFN75174363,2019-12-05
2019-12-05T005:08:30.000Z,M56234224,FT,1220,569648,DEBIT,UPI/455371968387/order/bescom/upi,RFN02735621,2019-12-05
2019-12-07T016:52:39.000Z,M11835931,FT,1430,568218,DEBIT,VIN/indianoil/678636508844/767471490515,RFN64635285,2019-12-07
2019-12-08T006:25:52.000Z,M04482535,FT,200,568018,DEBIT,UPI/732136724173/order/kwalitybazaar/ybl,RFN35693509,2019-12-08
2019-12-15T005:00:23.000Z,M63318892,FT,4299,572317,CREDIT,BIL/INF/310311946424/8884492110/8964034159,RFN84431734,2019-12-15
2019-12-09T002:02:12.000Z,M39568598,FT,1299,571018,DEBIT,UPI/031813953317/order/ionbroadband/oksbi,RFN07506976,2019-12-09
2019-12-10T019:38:00.000Z,M76342411,ATM,2500,568518,DEBIT,ATM/RFKHQ943/CASH WDL/2019-12-10,RFN22750331,2019-12-10
2019-12-11T008:15:42.000Z,M68946880,FT,430,568088,DEBIT,VPS/pvr/976019170531/337489706108/Begaluru,RFN30371069,2019-12-11
2019-12-12T009:38:24.000Z,M01751900,FT,743,567345,DEBIT,IIN/I-Debit/smokehouse/026885972862/929194417432,RFN65623379,2019-12-12
2019-12-12T019:54:11.000Z,M04960648,FT,500,566845,DEBIT,IPS/vedantsaxena/461748252736/537061508315/BANGALORE,RFN84973833,2019-12-12
2019-12-15T009:45:20.000Z,M37942879,FT,280,566565,DEBIT,UPI/757446996830/order/amul/okicici,RFN45967845,2019-12-15
2019-12-18T022:56:45.000Z,M21692077,FT,399,566166,DEBIT,UPI/894643385357/order/hairspeak/okhdfcbank,RFN28800294,2019-12-18
2019-12-18T010:28:02.000Z,M70199164,FT,350,565816,DEBIT,VIN/tatasky/480870110697/928332176343,RFN87486735,2019-12-18
2019-12-22T000:46:54.000Z,M49464561,FT,799,565017,DEBIT,IIN/I-Debit/netflix/645405917556/066527883820,RFN94286984,2019-12-22
2019-12-24T009:25:17.000Z,M66841723,FT,299,564718,DEBIT,VPS/pvr/227674437387/066531773667/BLR,RFN47180672,2019-12-24
2019-12-25T019:34:41.000Z,M65126655,FT,340,564378,DEBIT,UPI/505636925329/order/zomato/okaxis,RFN77086445,2019-12-25
2019-12-28T016:11:14.000Z,M84830198,FT,4999,559379,DEBIT,VPS/h&m/121612112951/299587744167/BLR,RFN06719306,2019-12-28
2019-12-28T008:25:43.000Z,M08483890,FT,5201,554178,DEBIT,ACH/indiafirstlifeinsurance/421167208/0091143363,RFN61980529,2019-12-28
2019-12-28T017:14:06.000Z,M68714117,FT,1900,552278,DEBIT,UPI/176032895267/order/dentistclinic/okhdfcbank,RFN64878463,2019-12-28
2019-12-31T023:35:19.000Z,M63666907,FT,25005,527273,DEBIT,MMT/IMPS/696937896837/axisprivilegeccpmt/axis/SIB,RFN96341923,2019-12-31
2019-12-31T007:03:41.000Z,M63555116,FT,15542,511731,DEBIT,MMT/IMPS/354771636288/sbieliteccpmt/axis/SBIN,RFN96216893,2019-12-31
2020-01-01T006:48:39.000Z,M08227386,FT,150000,661731,CREDIT,salfintechproductsandsolutions January 2020,RFN42655448,2020-01-01
2020-01-01T020:08:46.000Z,M15839342,FT,3567,658164,DEBIT,ACH/maxlifeinsurance/466793706/5514624773,RFN92631364,2020-01-01
2020-01-01T014:33:18.000Z,M99613045,FT,11345,646819,DEBIT,MMT/IMPS/191673806496/pnbpersonalloan/axis/BLR,RFN01023060,2020-01-01
2020-01-01T013:56:15.000Z,M76358073,FT,5000,641819,DEBIT,BIL/ONL/013844216627/motilaloswal/4052811038,RFN13513503,2020-01-01
2020-01-01T006:18:22.000Z,M39917511,FT,9000,632819,DEBIT,BIL/BPAY/252431664523/principalmutualfund/9408856250,RFN86290154,2020-01-01
2020-01-02T018:17:05.000Z,M87302654,FT,1209,631610,DEBIT,UPI/611409522783/order/kfc/upi,RFN92421582,2020-01-02
2020-01-03T005:36:02.000Z,M58777188,FT,1939,629671,DEBIT,IPS/spencers/246500060520/862468695064/BANGALORE,RFN50093694,2020-01-03
2020-01-03T023:43:56.000Z,M24422112,FT,14583,615088,DEBIT,MMT/IMPS/331101734411/idbihomeloan/axis/SBIN,RFN39635452,2020-01-03
2020-01-04T016:15:43.000Z,M54964184,FT,607,615695,CREDIT,BIL/INF/684761972817/88844432292110/6173855836,RFN33238024,2020-01-04
2020-01-04T019:48:15.000Z,M46958262,FT,12000,603695,DEBIT,MMT/IMPS/267391035986/rent/axis/SBIN,RFN57046113,2020-01-04
2020-01-04T022:30:58.000Z,M67237927,FT,3999,599696,DEBIT,VIN/h&m/344429126445/171034165150,RFN36534000,2020-01-04
2020-01-04T020:36:28.000Z,M12025459,FT,1999,597697,DEBIT,VIN/catwalk/212797848606/084609896518,RFN80084916,2020-01-04
2020-01-05T004:35:52.000Z,M16311001,FT,880,596817,DEBIT,UPI/223226381866/order/uber/ybl,RFN70580112,2020-01-05
2020-01-05T004:21:14.000Z,M71166260,FT,8902,587915,DEBIT,UPI/103760530595/order/gilly's/upi,RFN53153265,2020-01-05
2020-01-05T005:01:25.000Z,M76352911,FT,640,587275,DEBIT,UPI/948481661189/order/uber/ybl,RFN88690229,2020-01-05
2020-01-05T023:30:14.000Z,M50999200,FT,1380,585895,DEBIT,UPI/063925701440/order/bescom/oksbi,RFN77903827,2020-01-05
2020-01-07T003:49:10.000Z,M29102538,FT,20208,565687,DEBIT,VIN/cleartrip/025229290113/364994559237,RFN09149986,2020-01-07
2020-01-08T000:35:43.000Z,M81597358,FT,4999,560688,DEBIT,VIN/americantourister/497145927616/651136021998,RFN78997807,2020-01-08
2020-01-09T015:04:17.000Z,M09153262,FT,1299,559389,DEBIT,UPI/906581150909/order/ionbroadband/ybl,RFN72929348,2020-01-09
2020-01-12T009:17:26.000Z,M63237815,FT,3994,555395,DEBIT,VPS/veromoda/471026700815/385220175327/BANGALORE,RFN82010838,2020-01-12
2020-01-12T014:29:24.000Z,M88448663,FT,1410,553985,DEBIT,UPI/136260866762/order/kfc/oksbi,RFN36309100,2020-01-12
2020-01-15T003:11:45.000Z,M84913704,FT,480,553505,DEBIT,UPI/267570553155/order/stonedmonkey/okaxis,RFN92048597,2020-01-15
2020-01-18T011:46:58.000Z,M86049817,FT,750,552755,DEBIT,UPI/117979616468/order/zomato/okaxis,RFN58666170,2020-01-18
2020-01-18T012:25:18.000Z,M59372752,FT,350,552405,DEBIT,VIN/tatasky/337839337121/648485461299,RFN00761497,2020-01-18
2020-01-22T023:34:49.000Z,M57051137,FT,799,551606,DEBIT,IIN/I-Debit/netflix/849512837217/165101531932,RFN61214775,2020-01-22
2020-01-23T009:09:49.000Z,M18990670,FT,189,551417,DEBIT,VPS/pvr/392261199106/706395825086/BANGALORE,RFN46952885,2020-01-23
2020-01-24T011:58:45.000Z,M52096253,FT,2001,553418,CREDIT,BIL/INF/974007866840/00333954322234955/1241302538,RFN76126255,2020-01-24
2020-01-25T020:40:24.000Z,M76211591,FT,1440,551978,DEBIT,UPI/115282948205/order/amazon/okhdfcbank,RFN56586744,2020-01-25
2020-01-28T019:11:29.000Z,M15045626,FT,5201,546777,DEBIT,ACH/indiafirstlifeinsurance/084253155/4934971018,RFN82924673,2020-01-28
2020-01-28T015:30:54.000Z,M10297277,FT,1900,544877,DEBIT,UPI/880328612205/order/dentistclinic/oksbi,RFN03301451,2020-01-28
2020-01-28T002:11:22.000Z,M05624408,FT,399,544478,DEBIT,UPI/401003576490/order/kwalitybazaar/oksbi,RFN81916899,2020-01-28
2020-01-31T020:17:35.000Z,M29961787,FT,25005,519473,DEBIT,MMT/IMPS/926236891725/axisprivilegeccpmt/axis/SIB,RFN83620360,2020-01-31
2020-01-31T005:47:16.000Z,M89689105,FT,15542,503931,DEBIT,MMT/IMPS/030063163802/sbieliteccpmt/axis/KIN,RFN44724837,2020-01-31
2020-02-01T005:41:54.000Z,M37905324,FT,150000,653931,CREDIT,salfintechproductsandsolutions February 2020,RFN97683186,2020-02-01
2020-02-01T023:09:37.000Z,M56194567,FT,3567,650364,DEBIT,ACH/maxlifeinsurance/177876312/6541084259,RFN55392379,2020-02-01
2020-02-01T013:57:28.000Z,M41587869,FT,11345,639019,DEBIT,MMT/IMPS/146156264156/pnbpersonalloan/axis/SBIN,RFN35735557,2020-02-01
2020-02-01T020:51:33.000Z,M32563022,FT,5000,634019,DEBIT,BIL/INF/187497495023/motilaloswal/5231036329,RFN27166321,2020-02-01
2020-02-01T022:02:38.000Z,M43587673,FT,9000,625019,DEBIT,BIL/INF/511857788460/principalmutualfund/1511773588,RFN97315713,2020-02-01
2020-02-02T022:16:36.000Z,M69319403,FT,670,624349,DEBIT,UPI/808694572989/order/cafecofeeday/okhdfcbank,RFN81787343,2020-02-02
2020-02-03T006:55:04.000Z,M30974948,FT,3100,621249,DEBIT,IPS/spencers/048708924778/073498473963/BANGALORE,RFN81087204,2020-02-03
2020-02-03T003:54:03.000Z,M71798231,FT,14583,606666,DEBIT,MMT/IMPS/794111156867/idbihomeloan/axis/BLR,RFN45470434,2020-02-03
2020-02-04T001:16:19.000Z,M92441065,FT,12000,594666,DEBIT,MMT/IMPS/653942840779/rent/axis/SIB,RFN95182220,2020-02-04
2020-02-04T012:37:36.000Z,M90770447,FT,550,594116,DEBIT,VIN/kfc/774424067488/324937993551,RFN87006351,2020-02-04
2020-02-05T023:07:13.000Z,M53371103,FT,1380,592736,DEBIT,UPI/253070629651/order/bescom/okicici,RFN67318564,2020-02-05
2020-02-07T000:25:38.000Z,M48142241,FT,2500,590236,DEBIT,VIN/indianoil/236353172069/607769500402,RFN06190140,2020-02-07
2020-02-08T018:49:27.000Z,M96635282,FT,1200,589036,DEBIT,UPI/806046639539/order/kwalitybazaar/upi,RFN68111543,2020-02-08
2020-02-09T016:32:51.000Z,M84320670,FT,1299,587737,DEBIT,UPI/221177768415/order/ionbroadband/upi,RFN03165626,2020-02-09
2020-02-10T016:03:08.000Z,M54772606,FT,399,587338,DEBIT,UPI/823474960365/order/jio/okicici,RFN10065758,2020-02-10
2020-02-12T006:06:36.000Z,M51877462,FT,1800,585538,DEBIT,UPI/238227942052/order/gilly's/okaxis,RFN38420634,2020-02-12
2020-02-15T012:36:57.000Z,M61747021,FT,180,585358,DEBIT,UPI/576246047103/order/amul/upi,RFN27981536,2020-02-15
2020-02-18T000:43:45.000Z,M07047477,FT,160,585198,DEBIT,UPI/966876208064/order/1mg/upi,RFN90660730,2020-02-18
2020-02-18T003:27:12.000Z,M66552450,FT,350,584848,DEBIT,VIN/tatasky/354143795648/962825759217,RFN03889690,2020-02-18
2020-02-22T014:52:18.000Z,M61431328,FT,799,584049,DEBIT,IIN/I-Debit/netflix/707014246304/405602366459,RFN14875416,2020-02-22
2020-02-25T009:53:53.000Z,M75202791,FT,50,583999,DEBIT,UPI/274193050335/order/amul/oksbi,RFN10505539,2020-02-25
2020-02-28T015:15:33.000Z,M88655893,FT,310,583689,DEBIT,UPI/975042074990/order/uber/okaxis,RFN39102830,2020-02-28
2020-02-28T021:00:20.000Z,M48478410,FT,5201,578488,DEBIT,ACH/indiafirstlifeinsurance/340976029/9000160677,RFN47228853,2020-02-28
2020-02-28T014:48:34.000Z,M14406703,FT,1900,576588,DEBIT,UPI/248233269631/order/dentistclinic/okaxis,RFN67814060,2020-02-28
2020-02-28T020:24:08.000Z,M68692096,FT,330,576258,DEBIT,UPI/159925990600/order/uber/upi,RFN55544271,2020-02-28
2020-02-28T013:18:50.000Z,M32379953,FT,99,576159,DEBIT,UPI/015185588991/order/kwalitybazaar/okhdfcbank,RFN44536341,2020-02-28
2020-02-28T010:11:31.000Z,M49784413,FT,25005,551154,DEBIT,MMT/IMPS/995198088249/axisprivilegeccpmt/axis/SBIN,RFN06764826,2020-02-28
2020-02-28T020:51:48.000Z,M45786397,FT,15542,535612,DEBIT,MMT/IMPS/465453005186/sbieliteccpmt/axis/HDF,RFN41085804,2020-02-28
2020-03-01T002:00:15.000Z,M08338908,FT,150000,685612,CREDIT,salfintechproductsandsolutions March 2020,RFN03254064,2020-03-01
2020-03-01T000:00:16.000Z,M27012807,FT,3567,682045,DEBIT,ACH/maxlifeinsurance/268610537/6360371655,RFN99399307,2020-03-01
2020-03-01T013:52:51.000Z,M01424104,FT,11345,670700,DEBIT,MMT/IMPS/197268528448/pnbpersonalloan/axis/BLR,RFN21285644,2020-03-01
2020-03-01T010:31:30.000Z,M83034598,FT,5000,665700,DEBIT,BIL/BPAY/632130316764/motilaloswal/2504598829,RFN75573418,2020-03-01
2020-03-01T008:31:02.000Z,M36059609,FT,9000,656700,DEBIT,BIL/BPAY/776320112091/principalmutualfund/0331147806,RFN69233196,2020-03-01
2020-03-02T022:04:36.000Z,M31853718,FT,240,656460,DEBIT,UPI/898407140880/order/amul/okhdfcbank,RFN77266712,2020-03-02
2020-03-03T022:41:21.000Z,M17955873,FT,1536,654924,DEBIT,IPS/bigbasket/732801906678/913303376487/BANGALORE,RFN93157708,2020-03-03
2020-03-03T012:24:44.000Z,M97140642,FT,14583,640341,DEBIT,MMT/IMPS/369227001851/idbihomeloan/axis/HDF,RFN37975069,2020-03-03
2020-03-04T009:44:36.000Z,M05043765,FT,12000,628341,DEBIT,MMT/IMPS/967305960114/rent/axis/KIN,RFN77789104,2020-03-04
2020-03-04T016:25:11.000Z,M91561911,FT,242,628099,DEBIT,UPI/716791585476/order/leongrill/oksbi,RFN32120959,2020-03-04
2020-03-05T019:00:30.000Z,M32772177,FT,1561,626538,DEBIT,UPI/943076162884/order/bescom/upi,RFN12509523,2020-03-05
2020-03-07T012:20:42.000Z,M43860113,FT,1500,625038,DEBIT,VIN/indianoil/856061099393/871736937819,RFN59579636,2020-03-07
2020-03-08T008:15:41.000Z,M99023059,FT,220,624818,DEBIT,UPI/190170780003/order/sriganeshmedical/oksbi,RFN95414428,2020-03-08
2020-03-09T020:52:58.000Z,M29093484,FT,1299,623519,DEBIT,UPI/189315133112/order/ionbroadband/okicici,RFN63900182,2020-03-09
2020-03-11T002:50:55.000Z,M04730011,FT,3006,626525,CREDIT,BIL/BPAY/586654388590/23435678032/6075692668,RFN21709518,2020-03-11
2020-03-12T008:06:23.000Z,M74741122,FT,13999,612526,DEBIT,VPS/amazon/591017613699/194401849561/BANGALOR,RFN08611774,2020-03-12
2020-03-12T022:57:16.000Z,M52114708,FT,310,612216,DEBIT,IIN/I-Debit/a2b/960684784889/726440678280,RFN60463333,2020-03-12
2020-03-15T018:06:20.000Z,M74515946,FT,180,612036,DEBIT,UPI/380686387789/order/amul/okicici,RFN07688073,2020-03-15
2020-03-18T000:53:51.000Z,M26999647,FT,1400,610636,DEBIT,UPI/718943789452/order/myntra/okaxis,RFN59129694,2020-03-18
2020-03-18T002:22:19.000Z,M86345249,FT,350,610286,DEBIT,VIN/tatasky/193745369881/382036520192,RFN83203735,2020-03-18
2020-03-21T007:33:48.000Z,M44042742,FT,850,609436,DEBIT,VIN/bblunt/306211681711/415273709137,RFN60008714,2020-03-21
2020-03-22T002:17:04.000Z,M55688460,FT,799,608637,DEBIT,IIN/I-Debit/netflix/412468511102/372387598207,RFN52516585,2020-03-22
2020-03-28T017:03:51.000Z,M50665579,FT,5201,603436,DEBIT,ACH/indiafirstlifeinsurance/610952292/1807476108,RFN28769528,2020-03-28
2020-03-28T015:18:12.000Z,M99457944,FT,29,603407,DEBIT,UPI/940585053531/order/kwalitybazaar/okhdfcbank,RFN58991245,2020-03-28
2020-03-31T017:48:18.000Z,M84841199,FT,25005,578402,DEBIT,MMT/IMPS/075847287540/axisprivilegeccpmt/axis/HDF,RFN29577320,2020-03-31
2020-03-31T000:26:25.000Z,M44559485,FT,15542,562860,DEBIT,MMT/IMPS/075665624611/sbieliteccpmt/axis/HDF,RFN41932984,2020-03-31
2020-04-01T020:58:20.000Z,M28448092,FT,150000,712860,CREDIT,salfintechproductsandsolutions April 2020,RFN93629004,2020-04-01
2020-04-01T018:24:01.000Z,M34299434,FT,3567,709293,DEBIT,ACH/maxlifeinsurance/231109857/4016330236,RFN59726172,2020-04-01
2020-04-01T003:15:19.000Z,M21248656,FT,11345,697948,DEBIT,MMT/IMPS/475666315061/pnbpersonalloan/axis/KIN,RFN99332635,2020-04-01
2020-04-01T019:09:31.000Z,M06244744,FT,5000,692948,DEBIT,BIL/ONL/198043466216/motilaloswal/2500611395,RFN87538783,2020-04-01
2020-04-01T022:33:41.000Z,M20447140,FT,9000,683948,DEBIT,BIL/INF/301737328321/principalmutualfund/0478292448,RFN02263346,2020-04-01
2020-04-02T021:09:55.000Z,M46298748,FT,670,683278,DEBIT,UPI/571878180715/order/mrgoofy's/ybl,RFN66732544,2020-04-02
2020-04-03T014:31:04.000Z,M35749738,FT,1983,681295,DEBIT,IPS/spencers/087814251339/240318443678/BANGALORE,RFN33635124,2020-04-03
2020-04-03T022:57:53.000Z,M36060925,FT,14583,666712,DEBIT,MMT/IMPS/461074779613/idbihomeloan/axis/SBIN,RFN50623284,2020-04-03
2020-04-04T022:53:02.000Z,M05037348,FT,12000,654712,DEBIT,MMT/IMPS/401233676584/rent/axis/KIN,RFN81574768,2020-04-04
2020-04-04T020:46:48.000Z,M74281704,FT,667,654045,DEBIT,UPI/281560998001/order/zomato/okicici,RFN52279126,2020-04-04
2020-04-05T006:16:34.000Z,M12085023,FT,560,653485,DEBIT,UPI/789238596664/order/uber/okicici,RFN97803922,2020-04-05
2020-04-05T015:23:30.000Z,M59010507,FT,880,652605,DEBIT,UPI/360500038194/order/bescom/okicici,RFN00502038,2020-04-05
2020-04-05T005:57:33.000Z,M68844360,FT,2016,654621,CREDIT,BIL/BPAY/291585071272/435456745323234353/3247328395,RFN10318644,2020-04-05
2020-04-07T012:07:17.000Z,M68780268,FT,2000,652621,DEBIT,VIN/indianoil/560549337509/905933647653,RFN31369331,2020-04-07
2020-04-08T012:03:07.000Z,M82375097,FT,1299,651322,DEBIT,UPI/964193273380/order/skybags/okicici,RFN95986739,2020-04-08
2020-04-09T021:56:10.000Z,M39028420,FT,1299,650023,DEBIT,UPI/120154117310/order/ionbroadband/oksbi,RFN49444368,2020-04-09
2020-04-12T010:46:04.000Z,M75008865,FT,7999,642024,DEBIT,VIN/titaneyeplus/526576546466/932819391906,RFN73050216,2020-04-12
2020-04-12T021:22:21.000Z,M16372180,FT,3500,638524,DEBIT,IPS/rahulkumar/401453007067/494284414901/BANGALORE,RFN91571754,2020-04-12
2020-04-15T010:24:20.000Z,M12209286,FT,380,638144,DEBIT,UPI/359443503975/order/amul/oksbi,RFN97560273,2020-04-15
2020-04-18T002:58:20.000Z,M52222528,FT,2100,636044,DEBIT,VIN/only/266848557490/732974453993,RFN78086788,2020-04-18
2020-04-18T014:39:19.000Z,M57439178,FT,350,635694,DEBIT,VIN/tatasky/868194275440/100448099680,RFN07766694,2020-04-18
2020-04-22T006:29:19.000Z,M33265678,FT,799,634895,DEBIT,IIN/I-Debit/netflix/327977994289/193038878353,RFN81617738,2020-04-22
2020-04-24T005:04:45.000Z,M51847902,FT,499,634396,DEBIT,VPS/pvr/204830467675/942527141664/BENGALURU,RFN05969640,2020-04-24
2020-04-25T019:54:40.000Z,M22892065,FT,1510,632886,DEBIT,UPI/905367575559/order/landmark/upi,RFN44222216,2020-04-25
2020-04-28T004:32:41.000Z,M09037368,FT,5201,627685,DEBIT,ACH/indiafirstlifeinsurance/978833735/1553472681,RFN54414345,2020-04-28
2020-04-28T002:53:48.000Z,M99180496,FT,789,626896,DEBIT,VPS/irctc/548196465180/113691589405/BLR,RFN93453482,2020-04-28
2020-04-30T011:49:33.000Z,M46826521,FT,25005,601891,DEBIT,MMT/IMPS/761649335647/axisprivilegeccpmt/axis/BLR,RFN66756664,2020-04-30
2020-04-30T004:40:59.000Z,M15544134,FT,15542,586349,DEBIT,MMT/IMPS/161351610137/sbieliteccpmt/axis/HDF,RFN72811668,2020-04-30
2020-05-01T004:38:32.000Z,M16528498,FT,150000,736349,CREDIT,salfintechproductsandsolutions May 2020,RFN63521688,2020-05-01
2020-05-01T008:57:11.000Z,M49826453,FT,3567,732782,DEBIT,ACH/maxlifeinsurance/282938986/6592362676,RFN45244471,2020-05-01
2020-05-01T023:11:54.000Z,M05443261,FT,11345,721437,DEBIT,MMT/IMPS/053153113627/pnbpersonalloan/axis/SIB,RFN51156032,2020-05-01
2020-05-01T015:57:02.000Z,M76348462,FT,5000,716437,DEBIT,BIL/ONL/218771109935/motilaloswal/1867616252,RFN22889040,2020-05-01
2020-05-01T010:32:22.000Z,M18321962,FT,9000,707437,DEBIT,BIL/ONL/688455501804/principalmutualfund/8110118680,RFN16325494,2020-05-01
2020-05-02T020:01:27.000Z,M61919999,FT,160,707277,DEBIT,UPI/150293238019/order/amul/okicici,RFN61597411,2020-05-02
2020-05-03T003:20:24.000Z,M59657538,FT,3290,703987,DEBIT,IPS/spencers/398616895317/224301822342/BANGALORE,RFN18778554,2020-05-03
2020-05-03T023:22:27.000Z,M90547750,FT,14583,689404,DEBIT,MMT/IMPS/307675430066/idbihomeloan/axis/HDF,RFN67095583,2020-05-03
2020-05-04T011:04:21.000Z,M91559815,FT,12000,677404,DEBIT,MMT/IMPS/070715604074/rent/axis/SIB,RFN69723634,2020-05-04
2020-05-04T006:12:38.000Z,M16620036,FT,496,676908,DEBIT,VIN/eatfit/156089595707/390947773425,RFN80913028,2020-05-04
2020-05-04T007:22:34.000Z,M70588007,FT,6989,669919,DEBIT,VPS/h&m/219681642749/387557313189/BANGALORE,RFN81315779,2020-05-04
2020-05-04T009:18:16.000Z,M22363545,FT,4503,665416,DEBIT,VPS/bangalorecentral/606639054645/063829325108/bangalore,RFN60981590,2020-05-04
2020-05-05T015:34:18.000Z,M51828257,FT,402,665014,DEBIT,UPI/669175600808/order/uber/oksbi,RFN33955694,2020-05-05
2020-05-05T004:52:46.000Z,M94175385,FT,8472,656542,DEBIT,VIN/nolimmits/550517400530/029840942824,RFN71948483,2020-05-05
2020-05-05T019:10:26.000Z,M82151509,FT,442,656100,DEBIT,UPI/020129219849/order/uber/okicici,RFN74812351,2020-05-05
2020-05-05T010:34:12.000Z,M07730567,FT,1280,654820,DEBIT,UPI/282764518651/order/bescom/okicici,RFN73139000,2020-05-05
2020-05-07T022:16:08.000Z,M22605250,FT,1500,653320,DEBIT,VIN/indianoil/359238685830/585734246382,RFN02231818,2020-05-07
2020-05-08T015:59:00.000Z,M99538929,FT,799,652521,DEBIT,UPI/103018017060/order/bblunt/okicici,RFN99712292,2020-05-08
2020-05-09T010:58:57.000Z,M77276424,FT,1299,651222,DEBIT,UPI/111914126398/order/ionbroadband/ybl,RFN21355823,2020-05-09
2020-05-10T003:20:04.000Z,M42865928,FT,399,650823,DEBIT,UPI/645478542159/order/jio/ybl,RFN01761617,2020-05-10
2020-05-11T003:57:56.000Z,M79362010,FT,1540,652363,CREDIT,BIL/ONL/162479147582/48282029013/7635230949,RFN24230236,2020-05-11
2020-05-12T013:01:41.000Z,M55279028,FT,3289,649074,DEBIT,VPS/gilly's/961954492837/548554287565/BLR,RFN87474031,2020-05-12
2020-05-15T016:15:31.000Z,M85651429,FT,70,649004,DEBIT,UPI/652769841099/order/amul/okhdfcbank,RFN69065118,2020-05-15
2020-05-18T021:24:55.000Z,M97028224,ATM,3500,645504,DEBIT,ATM/VLZPN215/CASH WDL/2020-05-18,RFN85614371,2020-05-18
2020-05-18T011:43:23.000Z,M56026263,FT,350,645154,DEBIT,VIN/tatasky/547702311561/251370258909,RFN62728884,2020-05-18
2020-05-22T016:06:30.000Z,M65041419,FT,799,644355,DEBIT,IIN/I-Debit/netflix/004712263763/843990728917,RFN71619140,2020-05-22
2020-05-24T023:30:40.000Z,M79728870,FT,299,644056,DEBIT,VPS/pvr/828375397712/102616620960/BANGALORE,RFN51164392,2020-05-24
2020-05-25T017:52:53.000Z,M02402268,ATM,1000,643056,DEBIT,ATM/MQQNS364/CASH WDL/2020-05-25,RFN99768494,2020-05-25
2020-05-28T018:42:24.000Z,M08959548,FT,99,642957,DEBIT,UPI/847354159279/order/kwalitybazaar/okicici,RFN69324553,2020-05-28
2020-05-28T014:10:03.000Z,M05530148,FT,5201,637756,DEBIT,ACH/indiafirstlifeinsurance/141545938/6846195891,RFN43932527,2020-05-28
2020-05-31T020:21:42.000Z,M10114949,FT,25005,612751,DEBIT,MMT/IMPS/245973863154/axisprivilegeccpmt/axis/KIN,RFN59799850,2020-05-31
2020-05-31T015:17:44.000Z,M42550780,FT,15542,597209,DEBIT,MMT/IMPS/156602367569/sbieliteccpmt/axis/SIB,RFN85539598,2020-05-31
2020-06-01T000:53:55.000Z,M23356438,FT,150000,747209,CREDIT,salfintechproductsandsolutions June 2020,RFN50515348,2020-06-01
2020-06-01T011:02:11.000Z,M86317486,FT,3567,743642,DEBIT,ACH/maxlifeinsurance/188099281/6319412090,RFN61112503,2020-06-01
2020-06-01T015:03:15.000Z,M29314696,FT,11345,732297,DEBIT,MMT/IMPS/288051277583/pnbpersonalloan/axis/BLR,RFN08863634,2020-06-01
2020-06-01T000:59:28.000Z,M90103790,FT,5000,727297,DEBIT,BIL/ONL/774722573283/motilaloswal/0814388480,RFN95083296,2020-06-01
2020-06-01T015:55:16.000Z,M75785560,FT,9000,718297,DEBIT,BIL/INF/661243139375/principalmutualfund/5675115840,RFN97646500,2020-06-01
2020-06-02T017:37:15.000Z,M90315768,FT,89000,629297,DEBIT,VIN/iplanet/088533133004/768528648125,RFN75954505,2020-06-02
2020-06-03T010:51:44.000Z,M14175257,FT,1200,628097,DEBIT,IPS/bigbasket/096230125499/413325695891/BANGALORE,RFN54902192,2020-06-03
2020-06-03T011:55:12.000Z,M82683023,FT,14583,613514,DEBIT,MMT/IMPS/379289043471/idbihomeloan/axis/BLR,RFN34624887,2020-06-03
2020-06-04T015:13:42.000Z,M57746408,FT,12000,601514,DEBIT,MMT/IMPS/400857545215/rent/axis/HDF,RFN23870290,2020-06-04
2020-06-04T016:50:56.000Z,M12903632,FT,249,601265,DEBIT,VIN/kfc/560612061122/824140439297,RFN94277761,2020-06-04
2020-06-05T021:48:49.000Z,M18007173,FT,120,601145,DEBIT,UPI/549841714693/order/uber/oksbi,RFN69800786,2020-06-05
2020-06-05T023:46:12.000Z,M11728147,FT,1480,599665,DEBIT,UPI/679765165848/order/bescom/ybl,RFN19753221,2020-06-05
2020-06-07T005:26:26.000Z,M54371079,FT,2110,597555,DEBIT,UPI/821195450635/order/plated/okicici,RFN12929253,2020-06-07
2020-06-08T016:15:42.000Z,M37028627,ATM,2000,595555,DEBIT,ATM/FGCTA790/CASH WDL/2020-06-08,RFN09599517,2020-06-08
2020-06-08T003:40:24.000Z,M59265677,FT,3080,592475,DEBIT,VIN/landmark/399462787533/926533090807,RFN73816675,2020-06-08
2020-06-09T011:19:16.000Z,M74619345,FT,1299,591176,DEBIT,UPI/824518323150/order/ionbroadband/okicici,RFN77423099,2020-06-09
2020-06-12T016:15:48.000Z,M48521318,FT,9999,581177,DEBIT,VPS/adidas/383033625242/506732640828/BENGALURU,RFN66571664,2020-06-12
2020-06-12T020:31:48.000Z,M27083153,FT,230,580947,DEBIT,UPI/175202228159/order/eatfit/upi,RFN63446824,2020-06-12
2020-06-15T022:23:57.000Z,M54856750,FT,210,580737,DEBIT,UPI/277965261606/order/amul/oksbi,RFN82012656,2020-06-15
2020-06-18T018:37:55.000Z,M91281447,FT,599,580138,DEBIT,UPI/702320167357/order/croma/upi,RFN60627672,2020-06-18
2020-06-18T001:21:58.000Z,M81012280,FT,350,579788,DEBIT,VIN/tatasky/365669748083/581986404644,RFN46646906,2020-06-18
2020-06-19T017:35:29.000Z,M00722842,FT,4802,584590,CREDIT,BIL/ONL/302868487936/0292192233/8460186527,RFN20764066,2020-06-19
2020-06-19T001:42:01.000Z,M49602629,FT,300,584890,CREDIT,BIL/INF/224498146093/0324830223/8940882124,RFN77891361,2020-06-19
2020-06-22T021:29:02.000Z,M29936546,FT,799,584091,DEBIT,IIN/I-Debit/netflix/888080347027/071642147374,RFN66286061,2020-06-22
2020-06-28T002:35:04.000Z,M28295704,FT,5201,578890,DEBIT,ACH/indiafirstlifeinsurance/508315651/7124838049,RFN49666018,2020-06-28
2020-06-28T010:31:46.000Z,M66522045,FT,59,578831,DEBIT,UPI/117624452217/order/kwalitybazaar/oksbi,RFN60535533,2020-06-28
2020-06-30T004:00:45.000Z,M06421119,FT,25005,553826,DEBIT,MMT/IMPS/653582237535/axisprivilegeccpmt/axis/BLR,RFN61697493,2020-06-30
2020-06-30T022:58:03.000Z,M13232874,FT,15542,538284,DEBIT,MMT/IMPS/338310489432/sbieliteccpmt/axis/HDF,RFN15634843,2020-06-30
2020-07-01T019:39:07.000Z,M40784659,FT,150000,688284,CREDIT,salfintechproductsandsolutions July 2020,RFN72632816,2020-07-01
2020-07-01T009:53:05.000Z,M20579177,FT,3567,684717,DEBIT,ACH/maxlifeinsurance/138212827/1108396862,RFN85246854,2020-07-01
2020-07-01T008:29:26.000Z,M74230197,FT,11345,673372,DEBIT,MMT/IMPS/873398788671/pnbpersonalloan/axis/KIN,RFN80864748,2020-07-01
2020-07-01T001:12:55.000Z,M66803652,FT,5000,668372,DEBIT,BIL/ONL/082025695416/motilaloswal/6465210709,RFN04166336,2020-07-01
2020-07-01T001:09:19.000Z,M27268221,FT,9000,659372,DEBIT,BIL/INF/791325274335/principalmutualfund/2913215377,RFN03712217,2020-07-01
2020-07-02T004:59:28.000Z,M61980627,FT,230,659142,DEBIT,UPI/420328920602/order/amul/oksbi,RFN55550251,2020-07-02
2020-07-03T012:16:30.000Z,M33963172,FT,1599,657543,DEBIT,IPS/spencers/596375034626/574612182276/BANGALORE,RFN55785462,2020-07-03
2020-07-03T015:17:00.000Z,M82859260,FT,14583,642960,DEBIT,MMT/IMPS/032615182467/idbihomeloan/axis/BLR,RFN50772037,2020-07-03
2020-07-04T022:41:31.000Z,M85269080,FT,12000,630960,DEBIT,MMT/IMPS/084655616748/rent/axis/SIB,RFN92026628,2020-07-04
2020-07-04T006:46:10.000Z,M20935663,FT,242,630718,DEBIT,VIN/burgerking/910106890559/356150020811,RFN56709146,2020-07-04
2020-07-05T002:04:25.000Z,M48355282,FT,540,630178,DEBIT,UPI/839708475139/order/kfc/upi,RFN52653407,2020-07-05
2020-07-05T001:56:44.000Z,M42524538,FT,1542,628636,DEBIT,UPI/104562632362/order/bescom/upi,RFN16129230,2020-07-05
2020-07-07T015:53:05.000Z,M97458760,FT,2400,626236,DEBIT,VIN/indianoil/030853323012/874860973763,RFN45394782,2020-07-07
2020-07-08T017:43:18.000Z,M05351379,FT,3598,622638,DEBIT,UPI/797068848129/order/landmark/oksbi,RFN96273519,2020-07-08
2020-07-09T014:09:40.000Z,M46818052,FT,1299,621339,DEBIT,UPI/266743464740/order/ionbroadband/okaxis,RFN07958094,2020-07-09
2020-07-12T013:01:31.000Z,M87108326,FT,2889,618450,DEBIT,VPS/veromoda/523530622620/808125006972/BANGALORE,RFN01488580,2020-07-12
2020-07-12T010:56:14.000Z,M46348007,FT,410,618040,DEBIT,UPI/099993945404/order/eatfit/oksbi,RFN69486292,2020-07-12
2020-07-15T019:01:06.000Z,M40992080,FT,790,617250,DEBIT,UPI/012898065948/order/beijingbites/ybl,RFN34730864,2020-07-15
2020-07-16T007:34:15.000Z,M02272882,FT,3123,620373,CREDIT,BIL/BPAY/985536741217/323455920392/0267561641,RFN98188198,2020-07-16
2020-07-18T000:51:27.000Z,M08042608,FT,3999,616374,DEBIT,UPI/397601643440/order/bangalorecentral/ybl,RFN43735786,2020-07-18
2020-07-18T012:43:54.000Z,M38628132,FT,350,616024,DEBIT,VIN/tatasky/150946534653/104820253369,RFN92584315,2020-07-18
2020-07-22T004:28:12.000Z,M74598233,FT,799,615225,DEBIT,IIN/I-Debit/netflix/383700383426/693518390978,RFN84516064,2020-07-22
2020-07-24T014:43:25.000Z,M88738533,FT,450,614775,DEBIT,VPS/pvr/420861554449/476212726002/bangalore,RFN53656236,2020-07-24
2020-07-25T002:56:43.000Z,M63259452,FT,50,614725,DEBIT,UPI/783303751820/order/amul/okaxis,RFN28080821,2020-07-25
2020-07-28T017:59:57.000Z,M31274844,FT,5201,609524,DEBIT,ACH/indiafirstlifeinsurance/832556730/7543447072,RFN64260128,2020-07-28
2020-07-28T021:09:32.000Z,M17727472,FT,120,609404,DEBIT,UPI/361230813207/order/kwalitybazaar/okicici,RFN31730790,2020-07-28
2020-07-31T022:21:11.000Z,M53161122,FT,25005,584399,DEBIT,MMT/IMPS/094116936816/axisprivilegeccpmt/axis/BLR,RFN08961684,2020-07-31
2020-07-31T000:24:53.000Z,M39023537,FT,15542,568857,DEBIT,MMT/IMPS/247895781651/sbieliteccpmt/axis/KIN,RFN78948875,2020-07-31
2020-07-31T023:47:19.000Z,M82328213,ATM,5000,563857,DEBIT,ATM/UAYOM681/CASH WDL/2020-07-31,RFN05137174,2020-07-31
